a	ah
abandon	ah b ae n d ah n
abandoned	ah b ae n d ah n d
abandonment	ah b ae n d ah n m ah n t
abated	ah b ey t ih d
abdomen	ae b d ow m ah n
abide	ah b ay d
abides	ah b ay d z
ability	ah b ih l ah t iy
able	ey b ah l
aboard	ah b ao r d
abode	ah b ow d
abound	ah b aw n d
abounds	ah b aw n d z
about	ah b aw t
above	ah b ah v
abroad	ah b r ao d
abruptly	ah b r ah p t l iy
absence	ae b s ah n s
absolutely	ae b s ah l uw t l iy
absorbed	ah b z ao r b d
absorbing	ah b z ao r b ih ng
absorbs	ah b z ao r b z
abstract	ae b s t r ae k t
abutted	ah b ah t ah d
abysmal	ah b ih z m ah l
abyss	ah b ih s
accede	ae k s iy d
acceding	ae k s iy d ih ng
accentuated	ae k s eh n ch uw ey t ih d
accept	ae k s eh p t
accepted	ae k s eh p t ih d
access	ae k s eh s
accessible	ae k s eh s ah b ah l
accident	ae k s ah d ah n t
accommodate	ah k aa m ah d ey t
accompanied	ah k ah m p ah n iy d
accompany	ah k ah m p ah n iy
accomplice	ah k aa m p l ah s
accomplish	ah k aa m p l ih sh
accomplished	ah k aa m p l ih sh t
accomplishes	ah k aa m p l ih sh ih z
accomplishment	ah k aa m p l ih sh m ah n t
accord	ah k ao r d
accordance	ah k ao r d ah n s
accorded	ah k ao r d ih d
according	ah k ao r d ih ng
account	ah k aw n t
accounted	ah k aw n t ih d
accounting	ah k aw n t ih ng
accoutrements	ah k uw t er m ah n t s
accumulation	ah k y uw m y ah l ey sh ah n
accurate	ae k y er ah t
accusing	ah k y uw z ih ng
accustomed	ah k ah s t ah m d
acknowledge	ae k n aa l ih jh
acquainted	ah k w ey n t ih d
acquiescence	ae k w iy eh s ah n s
acquired	ah k w ay er d
acquitted	ah k w ih t ih d
acre	ey k er
acres	ey k er z
across	ah k r ao s
act	ae k t
acted	ae k t ih d
acting	ae k t ih ng
action	ae k sh ah n
actions	ae k sh ah n z
activity	ae k t ih v ih t iy
acts	ae k t s
add	ae d
added	ae d ih d
adding	ae d ih ng
addition	ah d ih sh ah n
additional	ah d ih sh ah n ah l
address	ae d r eh s
addressed	ah d r eh s t
addressing	ae d r eh s ih ng
adds	ae d z
adherence	ah d hh ih r ah n s
adjacent	ah jh ey s ah n t
adjoining	ah jh oy n ih ng
admiration	ae d m er ey sh ah n
admired	ah d m ay er d
admit	ah d m ih t
admitted	ah d m ih t ah d
admonished	ah d m aa n ih sh t
ado	ah d uw
adonis	ah d aa n ah s
adopted	ah d aa p t ah d
adroit	ah d r oy t
adult	ah d ah l t
adults	ah d ah l t s
advance	ah d v ae n s
advanced	ah d v ae n s t
advancing	ah d v ae n s ih ng
advantage	ae d v ae n t ih jh
advantaged	ae d v ae n t ih jh d
advent	ae d v eh n t
adventure	ae d v eh n ch er
adventures	ae d v eh n ch er z
adversaries	ae d v er s eh r iy z
adversary	ae d v er s eh r iy
advise	ae d v ay z
advised	ae d v ay z d
aerial	eh r iy ah l
affair	ah f eh r
affection	ah f eh k sh ah n
affects	ah f eh k t s
affixed	ah f ih k s t
afford	ah f ao r d
afforded	ah f ao r d ah d
affront	ah f r ah n t
afoot	ah f uh t
afraid	ah f r ey d
african	ae f r ih k aa n
after	ae f t er
afternoon	ae f t er n uw n
afterward	ae f t er w er d
again	ah g eh n
against	ah g eh n s t
age	ey jh
aged	ey jh d
agency	ey jh ah n s iy
agent	ey jh ah n t
ages	ey jh ih z
aggrandizement	ae g r ah n d ay z m ah n t
aggrieved	ah g r iy v d
agile	ae jh ah l
agility	ah jh ih l ah t iy
agitated	ae jh ah t ey t ah d
ago	ah g ow
agonies	ae g ah n iy z
agony	ae g ah n iy
agree	ah g r iy
agreed	ah g r iy d
agreeing	ah g r iy ih ng
ah	aa
ahead	ah hh eh d
aid	ey d
aides	ey d z
aiding	ey d ih ng
aimlessly	ey m l ah s l iy
aims	ey m z
air	eh r
aisle	ay l
ajar	ah jh aa r
akin	ah k ih n
alarm	ah l aa r m
alarmed	ah l aa r m d
alien	ey l iy ah n
alight	ah l ay t
alike	ah l ay k
alive	ah l ay v
all	ao l
allegiance	ah l iy jh ah n s
alliance	ah l ay ah n s
allied	ah l ay d
allies	ae l ay z
allotted	ah l aa t ih d
allow	ah l aw
allowed	ah l aw d
allows	ah l aw z
alluring	ah l uh r ih ng
ally	ae l ay
almost	ao l m ow s t
aloft	ah l ao f t
alone	ah l ow n
along	ah l ao ng
alongside	ah l ao ng s ay d
aloof	ah l uw f
aloud	ah l aw d
already	ao l r eh d iy
also	ao l s ow
altars	ao l t er z
alter	ao l t er
alternately	ao l t er n ah t l iy
alternative	ao l t er n ah t ih v
although	ao l dh ow
altitude	ae l t ah t uw d
altogether	ao l t ah g eh dh er
aluminum	ah l uw m ah n ah m
always	ao l w ey z
am	ae m
amalgamation	ah m ae l g ah m ey sh ah n
amazed	ah m ey z d
amazement	ah m ey z m ah n t
amazing	ah m ey z ih ng
ambition	ae m b ih sh ah n
ambitions	ae m b ih sh ah n z
american	ah m eh r ih k ah n
amid	ah m ih d
amidst	ah m ih d s t
amiss	ah m ih s
ammunition	ae m y ah n ih sh ah n
among	ah m ah ng
amongst	ah m ah ng s t
amounted	ah m aw n t ih d
amphitheatre	ae m f ah th iy ey t er
ample	ae m p ah l
amply	ae m p l iy
amused	ah m y uw z d
amusement	ah m y uw z m ah n t
an	ae n
anaesthesia	ae n ih s th iy zh iy ah
ancestor	ae n s eh s t er
ancestors	ae n s eh s t er z
anchor	ae ng k er
anchoring	ae ng k er ih ng
ancient	ey n ch ah n t
ancients	ey n ch ah n t s
and	ah n d
anger	ae ng g er
angered	ae ng g er d
angle	ae ng g ah l
angles	ae ng g ah l z
angry	ae ng g r iy
anguish	ae ng g w ih sh
animal	ae n ah m ah l
animals	ae n ah m ah l z
ankle	ae ng k ah l
ankles	ae ng k ah l z
annals	ae n ah l z
annihilate	ah n ay ah l ey t
anniversary	ae n ah v er s er iy
announce	ah n aw n s
another	ah n ah dh er
answer	ae n s er
answered	ae n s er d
answering	ae n s er ih ng
antagonist	ae n t ae g ah n ah s t
antagonists	ae n t ae g ah n ah s t s
antennae	ae n t eh n iy
anticipated	ae n t ih s ah p ey t ah d
anticipation	ae n t ih s ah p ey sh ah n
antiquity	ae n t ih k w ah t iy
anxiety	ae ng z ay ah t iy
any	eh n iy
anything	eh n iy th ih ng
apart	ah p aa r t
apartment	ah p aa r t m ah n t
apartments	ah p aa r t m ah n t s
ape	ey p
aperture	ae p er ch er
apes	ey p s
apex	ey p eh k s
aphorism	ae f er ih z ah m
apologizing	ah p aa l ah jh ay z ih ng
appalling	ah p ao l ih ng
apparel	ah p ae r ah l
apparent	ah p eh r ah n t
apparently	ah p eh r ah n t l iy
appeal	ah p iy l
appear	ah p ih r
appearance	ah p ih r ah n s
appeared	ah p ih r d
appearing	ah p ih r ih ng
appears	ah p ih r z
applied	ah p l ay d
appoint	ah p oy n t
appointed	ah p oy n t ah d
appraising	ah p r ey z ih ng
appreciably	ah p r iy sh ah b l iy
appreciate	ah p r iy sh iy ey t
appreciated	ah p r iy sh iy ey t ih d
appreciating	ah p r iy sh iy ey t ih ng
appreciation	ah p r iy sh iy ey sh ah n
appreciative	ah p r iy sh iy ey t ih v
apprehended	ae p r ih hh eh n d ah d
apprehension	ae p r ih hh eh n sh ah n
apprehensive	ae p r ih hh eh n s ih v
apprise	ah p r ay z
apprised	ah p r ay z d
approach	ah p r ow ch
approached	ah p r ow ch t
approaching	ah p r ow ch ih ng
approximate	ah p r aa k s ah m ah t
approximated	ah p r aa k s ah m ey t ah d
apt	ae p t
arbiters	aa r b ah t er z
arch	aa r ch
arched	aa r ch t
architecture	aa r k ah t eh k ch er
arduous	aa r jh uw ah s
are	aa r
area	eh r iy ah
areas	eh r iy ah z
arena	er iy n ah
argued	aa r g y uw d
argument	aa r g y ah m ah n t
arid	ae r ah d
arise	er ay z
arisen	er ih z ah n
arizona	eh r ih z ow n ah
arm	aa r m
armed	aa r m d
arming	aa r m ih ng
armpits	aa r m p ih t s
arms	aa r m z
arose	er ow z
around	er aw n d
aroused	er aw z d
arousing	er aw z ih ng
arrange	er ey n jh
arrangement	er ey n jh m ah n t
arrest	er eh s t
arrival	er ay v ah l
arrived	er ay v d
art	aa r t
arteries	aa r t er iy z
artificial	aa r t ah f ih sh ah l
artisans	aa r t ah z ah n z
arts	aa r t s
as	ae z
ascend	ah s eh n d
ascended	ah s eh n d ah d
ascending	ah s eh n d ih ng
ascent	ah s eh n t
ascertain	ae s er t ey n
ashamed	ah sh ey m d
aside	ah s ay d
ask	ae s k
asked	ae s k t
asking	ae s k ih ng
asleep	ah s l iy p
aspect	ae s p eh k t
aspirations	ae s p er ey sh ah n z
assailant	ah s ey l ah n t
assailants	ah s ey l ah n t s
assailed	ah s ey l d
assassin	ah s ae s ah n
assassins	ah s ae s ah n z
assault	ah s ao l t
assaulted	ah s ao l t ih d
assemble	ah s eh m b ah l
assembling	ah s eh m b ah l ih ng
assembly	ah s eh m b l iy
assent	ah s eh n t
assert	ah s er t
assigned	ah s ay n d
assist	ah s ih s t
associated	ah s ow s iy ey t ah d
assumed	ah s uw m d
assuming	ah s uw m ih ng
assurance	ah sh uh r ah n s
assure	ah sh uh r
assured	ah sh uh r d
astonished	ah s t aa n ih sh t
astonishment	ah s t aa n ih sh m ah n t
astride	ah s t r ay d
astronomer	ah s t r aa n ah m er
asunder	ah s ah n d er
at	ae t
athletic	ae th l eh t ih k
atmosphere	ae t m ah s f ih r
atone	ah t ow n
atonement	ah t ow n m ah n t
atrocious	ah t r ow sh ah s
atrocities	ah t r aa s ah t iy z
attached	ah t ae ch t
attack	ah t ae k
attackers	ah t ae k er z
attacking	ah t ae k ih ng
attacks	ah t ae k s
attempt	ah t eh m p t
attempted	ah t eh m p t ah d
attempting	ah t eh m p t ih ng
attempts	ah t eh m p t s
attend	ah t eh n d
attended	ah t eh n d ah d
attention	ah t eh n sh ah n
attentions	ah t eh n sh ah n z
attested	ah t eh s t ih d
attitude	ae t ah t uw d
attract	ah t r ae k t
attracted	ah t r ae k t ah d
attraction	ah t r ae k sh ah n
attribute	ah t r ih b y uw t
attributes	ah t r ih b y uw t s
audibly	aa d ah b l iy
audience	aa d iy ah n s
aught	ao t
august	aa g ah s t
author	ao th er
authority	ah th ao r ah t iy
auxiliary	aa g z ih l y er iy
avail	ah v ey l
available	ah v ey l ah b ah l
avenge	ah v eh n jh
avenue	ae v ah n uw
avenues	ae v ah n uw z
avert	ah v er t
await	ah w ey t
awaited	ah w ey t ih d
awaiting	ah w ey t ih ng
awaits	ah w ey t s
awake	ah w ey k
awaken	ah w ey k ah n
awakened	ah w ey k ah n d
awakening	ah w ey k ah n ih ng
aware	ah w eh r
away	ah w ey
awe	aa
awed	ao d
awesome	ao s ah m
awful	ao f ah l
awoke	ah w ow k
axis	ae k s ah s
azure	ae zh er
b	b iy
back	b ae k
backed	b ae k t
background	b ae k g r aw n d
backing	b ae k ih ng
backs	b ae k s
backward	b ae k w er d
bad	b ae d
bade	b ey d
badly	b ae d l iy
baffling	b ae f ah l ih ng
balance	b ae l ah n s
balanced	b ae l ah n s t
balancing	b ae l ah n s ih ng
balconies	b ae l k ah n iy z
balcony	b ae l k ah n iy
bald	b ao l d
baleful	b ey l f ah l
balked	b ao k t
ball	b ao l
band	b ae n d
banished	b ae n ih sh t
bank	b ae ng k
banks	b ae ng k s
barbaric	b aa r b ae r ih k
bare	b eh r
bared	b eh r d
barely	b eh r l iy
barest	b eh r ah s t
bargain	b aa r g ah n
barges	b aa r jh ah z
barred	b aa r d
barrier	b ae r iy er
barriers	b ae r iy er z
bars	b aa r z
base	b ey s
based	b ey s t
basis	b ey s ah s
bathed	b ey dh d
bathing	b ey dh ih ng
batteries	b ae t er iy z
battle	b ae t ah l
battles	b ae t ah l z
battleship	b ae t ah l sh ih p
battleships	b ae t ah l sh ih p s
battling	b ae t ah l ih ng
be	b iy
beach	b iy ch
beams	b iy m z
bear	b eh r
bearable	b eh r ah b ah l
bearer	b eh r er
bearing	b eh r ih ng
beast	b iy s t
beasts	b iy s t s
beat	b iy t
beaten	b iy t ah n
beating	b iy t ih ng
beats	b iy t s
beauties	b y uw t iy z
beautiful	b y uw t ah f ah l
beauty	b y uw t iy
became	b ih k ey m
because	b ih k ao z
beckoning	b eh k ah n ih ng
become	b ih k ah m
becoming	b ih k ah m ih ng
bed	b eh d
bedecked	b ih d eh k t
been	b ih n
befall	b ih f ao l
befallen	b ah f aa l ah n
befitting	b ih f ih t ih ng
before	b ih f ao r
beg	b eh g
began	b ih g ae n
begged	b eh g d
beginning	b ih g ih n ih ng
begotten	b iy g ao t ih n
begun	b ih g ah n
behalf	b ih hh ae f
beheld	b iy hh eh l d
behest	b ih hh eh s t
behind	b ih hh ay n d
behold	b ih hh ow l d
behooves	b ih hh uw v z
being	b iy ih ng
beings	b iy ih ng z
belief	b ih l iy f
believe	b ih l iy v
believed	b ih l iy v d
believing	b ih l iy v ih ng
bellow	b eh l ow
bellowed	b eh l ow d
belly	b eh l iy
belong	b ih l ao ng
belonged	b ih l ao ng d
beloved	b ih l ah v d
below	b ih l ow
ben	b eh n
bench	b eh n ch
benches	b eh n ch ih z
bend	b eh n d
bending	b eh n d ih ng
beneath	b ih n iy th
benefactor	b eh n ah f ae k t er
benign	b ih n ay n
bent	b eh n t
berated	b ih r ey t ih d
beset	b ih s eh t
besetting	b ih s eh t ih ng
beside	b ih s ay d
besides	b ih s ay d z
best	b eh s t
bested	b eh s t ih d
bestial	b eh s ch ah l
bestiality	b eh s ch ae l ih t iy
betrayed	b ih t r ey d
better	b eh t er
between	b ih t w iy n
beware	b ih w eh r
bewildering	b ih w ih l d er ih ng
bewilderment	b ih w ih l d er m ah n t
beyond	b ih aa n d
biased	b ay ah s t
bid	b ih d
bidding	b ih d ih ng
bids	b ih d z
big	b ih g
bigger	b ih g er
bigness	b ih g n ah s
billions	b ih l y ah n z
billows	b ih l ow z
bind	b ay n d
binding	b ay n d ih ng
birds	b er d z
birth	b er th
bisexuality	b ay s eh k sh uw ae l ah t iy
bit	b ih t
bite	b ay t
bitter	b ih t er
bitterness	b ih t er n ah s
black	b l ae k
blackest	b l ae k ah s t
blackness	b l ae k n ah s
blacks	b l ae k s
blade	b l ey d
blades	b l ey d z
blame	b l ey m
blanch	b l ae n ch
blank	b l ae ng k
blasphemous	b l ae s f ah m ah s
blasphemy	b l ae s f ah m iy
blasted	b l ae s t ah d
blasting	b l ae s t ih ng
blazed	b l ey z d
blazing	b l ey z ih ng
bleak	b l iy k
bleed	b l iy d
bleeding	b l iy d ih ng
blessed	b l eh s t
blew	b l uw
blind	b l ay n d
blinded	b l ay n d ih d
blinding	b l ay n d ih ng
block	b l aa k
blocked	b l aa k t
blood	b l ah d
bloodshed	b l ah d sh eh d
bloodsucking	b l ah d s ah k ih ng
bloody	b l ah d iy
blooms	b l uw m z
blossomed	b l aa s ah m d
blossoms	b l aa s ah m z
blotted	b l aa t ah d
blow	b l ow
blows	b l ow z
blue	b l uw
bluff	b l ah f
bluffs	b l ah f s
blundered	b l ah n d er d
blur	b l er
blurred	b l er d
board	b ao r d
boarded	b ao r d ah d
boarders	b ao r d er z
boarding	b ao r d ih ng
boards	b ao r d z
boat	b ow t
boats	b ow t s
bodes	b ow d z
bodies	b aa d iy z
bodily	b aa d ah l iy
body	b aa d iy
boiling	b oy l ih ng
bold	b ow l d
boldly	b ow l d l iy
boldness	b ow l d n ah s
bolt	b ow l t
bolts	b ow l t s
bomb	b aa m
bombs	b aa m z
bond	b aa n d
bondage	b aa n d ih jh
bonds	b aa n d z
bone	b ow n
bones	b ow n z
bony	b ow n iy
book	b uh k
boom	b uw m
boon	b uw n
bore	b ao r
born	b ao r n
borne	b ao r n
bosom	b uh z ah m
both	b ow th
bottle	b aa t ah l
bottled	b aa t ah l d
bottom	b aa t ah m
bottomless	b aa t ah m l ah s
bottoms	b aa t ah m z
boulder	b ow l d er
boulders	b ow l d er z
bounce	b aw n s
bound	b aw n d
boundary	b aw n d er iy
bounded	b aw n d ah d
bounding	b aw n d ih ng
bounds	b aw n d z
bow	b aw
bowed	b aw d
bowels	b aw ah l z
bowl	b ow l
bows	b aw z
boy	b oy
brain	b r ey n
branch	b r ae n ch
branches	b r ae n ch ah z
brave	b r ey v
bravery	b r ey v er iy
bravest	b r ey v ah s t
brazen	b r ey z ah n
breach	b r iy ch
break	b r ey k
breaking	b r ey k ih ng
breakneck	b r ey k n eh k
breast	b r eh s t
breath	b r eh th
breathe	b r iy dh
breathed	b r iy dh d
breathing	b r iy dh ih ng
bred	b r eh d
breed	b r iy d
breeze	b r iy z
bribes	b r ay b z
bridge	b r ih jh
bridle	b r ay d ah l
brief	b r iy f
briefly	b r iy f l iy
bright	b r ay t
brightened	b r ay t ah n d
brighter	b r ay t er
brightly	b r ay t l iy
brilliant	b r ih l y ah n t
brilliantly	b r ih l y ah n t l iy
bring	b r ih ng
bringing	b r ih ng ih ng
brings	b r ih ng z
brink	b r ih ng k
broad	b r ao d
broader	b r ao d er
broadside	b r ao d s ay d
broke	b r ow k
broken	b r ow k ah n
brooding	b r uw d ih ng
brother	b r ah dh er
brought	b r ao t
brow	b r aw
brows	b r aw z
bruise	b r uw z
bruises	b r uw z ah z
brushed	b r ah sh t
brutal	b r uw t ah l
brute	b r uw t
buckle	b ah k ah l
buckled	b ah k ah l d
buckles	b ah k ah l z
bud	b ah d
budge	b ah jh
buds	b ah d z
build	b ih l d
building	b ih l d ih ng
buildings	b ih l d ih ng z
built	b ih l t
bulbs	b ah l b z
bulged	b ah l jh d
bulging	b ah l jh ih ng
bulk	b ah l k
bullet	b uh l ah t
bump	b ah m p
buoyancy	b oy ah n s iy
burden	b er d ah n
burdened	b er d ah n d
burdening	b er d ah n ih ng
buried	b eh r iy d
burly	b er l iy
burned	b er n d
burning	b er n ih ng
burnished	b er n ih sh t
burst	b er s t
bursting	b er s t ih ng
business	b ih z n ah s
but	b ah t
butchered	b uh ch er d
button	b ah t ah n
buttons	b ah t ah n z
buzz	b ah z
by	b ay
bye	b ay
bygone	b ay g ao n
cabbage	k ae b ah jh
cabin	k ae b ah n
cabins	k ae b ah n z
cage	k ey jh
cages	k ey jh ih z
calamities	k ah l ae m ah t iy z
calamity	k ah l ae m ah t iy
calculate	k ae l k y ah l ey t
calculated	k ae l k y ah l ey t ah d
call	k ao l
called	k ao l d
caller	k ao l er
calling	k ao l ih ng
came	k ey m
camp	k ae m p
campaign	k ae m p ey n
can	k ae n
cannot	k ae n aa t
canoe	k ah n uw
cans	k ae n z
canyon	k ae n y ah n
cap	k ae p
capable	k ey p ah b ah l
capacity	k ah p ae s ah t iy
capes	k ey p s
captain	k ae p t ah n
captive	k ae p t ih v
captives	k ae p t ih v z
captivity	k ae p t ih v ah t iy
captor	k ae p t er
captors	k ae p t er z
capture	k ae p ch er
captured	k ae p ch er d
capturing	k ae p ch er ih ng
car	k aa r
carborundum	k aa r b er ah n d ah m
carcass	k aa r k ah s
card	k aa r d
care	k eh r
cared	k eh r d
careened	k er iy n d
career	k er ih r
careful	k eh r f ah l
carefully	k eh r f ah l iy
carelessness	k eh r l eh s n ah s
caresses	k er eh s ih z
carpet	k aa r p ah t
carriage	k ae r ih jh
carried	k ae r iy d
carries	k ae r iy z
carry	k ae r iy
carrying	k ae r iy ih ng
cars	k aa r z
carter	k aa r t er
cartridges	k aa r t r ah jh ah z
carved	k aa r v d
case	k ey s
casket	k ae s k ah t
cast	k ae s t
casting	k ae s t ih ng
casual	k ae zh ah w ah l
cat	k ae t
catastrophe	k ah t ae s t r ah f iy
catch	k ae ch
caterpillar	k ae t ah p ih l er
cats	k ae t s
cattle	k ae t ah l
caught	k aa t
cause	k aa z
caused	k aa z d
causes	k aa z ah z
caution	k aa sh ah n
cautioned	k aa sh ah n d
cautioning	k ao sh ah n ih ng
cautiously	k ao sh ah s l iy
cave	k ey v
caves	k ey v z
cease	s iy s
ceased	s iy s t
ceiling	s iy l ih ng
celestial	s ah l eh s ch ah l
cell	s eh l
cells	s eh l z
cemetery	s eh m ah t eh r iy
central	s eh n t r ah l
centre	s eh n t er
centuries	s eh n ch er iy z
ceremony	s eh r ah m ow n iy
certain	s er t ah n
certainly	s er t ah n l iy
certainty	s er t ah n t iy
chafed	ch ey f t
chagrin	sh ah g r ih n
chain	ch ey n
chained	ch ey n d
chains	ch ey n z
chair	ch eh r
challenge	ch ae l ah n jh
chamber	ch ey m b er
chambers	ch ey m b er z
chance	ch ae n s
chances	ch ae n s ah z
changed	ch ey n jh d
changes	ch ey n jh ah z
changing	ch ey n jh ih ng
chanted	ch ae n t ih d
chapter	ch ae p t er
character	k eh r ih k t er
characteristic	k eh r ih k t er ih s t ih k
characteristics	k eh r ih k t er ih s t ih k s
characters	k ae r ih k t er z
charge	ch aa r jh
charged	ch aa r jh d
charging	ch aa r jh ih ng
charity	ch eh r ih t iy
charm	ch aa r m
charts	ch aa r t s
chase	ch ey s
chasm	k ae z ah m
cheat	ch iy t
check	ch eh k
cheek	ch iy k
cheer	ch ih r
cheering	ch ih r ih ng
cheers	ch ih r z
chemical	k eh m ih k ah l
chemicals	k eh m ih k ah l z
cherished	ch eh r ih sh t
chief	ch iy f
chieftain	ch iy f t ah n
chieftains	ch iy f t ah n z
child	ch ay l d
childhood	ch ay l d hh uh d
children	ch ih l d r ah n
chin	ch ih n
china	ch ay n ah
chivalry	sh ih v ah l r iy
choice	ch oy s
choked	ch ow k t
choking	ch ow k ih ng
choose	ch uw z
choosing	ch uw z ih ng
chose	ch ow z
chosen	ch ow z ah n
chronicler	k r aa n ih k l er
churning	ch er n ih ng
chute	sh uw t
cipher	s ay f er
circle	s er k ah l
circled	s er k ah l d
circles	s er k ah l z
circling	s er k ah l ih ng
circuitous	s er k y uw ih t ah s
circular	s er k y ah l er
circumstance	s er k ah m s t ae n s
circumstances	s er k ah m s t ae n s ah z
cities	s ih t iy z
citizen	s ih t ah z ah n
citizens	s ih t ah z ah n z
city	s ih t iy
civil	s ih v ah l
civilized	s ih v ah l ay z d
claim	k l ey m
clank	k l ae ng k
clanking	k l ae ng k ih ng
clapped	k l ae p t
clash	k l ae sh
clashing	k l ae sh ih ng
clasped	k l ae s p t
class	k l ae s
classes	k l ae s ah z
classifying	k l ae s ah f ay ih ng
clattering	k l ae t er ih ng
clawed	k l ao d
clawing	k l ao ih ng
claws	k l ao z
clean	k l iy n
clear	k l ih r
cleared	k l ih r d
clearing	k l ih r ih ng
cleave	k l iy v
cleaves	k l iy v z
clenched	k l eh n ch t
click	k l ih k
clicked	k l ih k t
cliff	k l ih f
cliffs	k l ih f s
climb	k l ay m
climbed	k l ay m d
climbers	k l ay m er z
climbing	k l ay m ih ng
cling	k l ih ng
clinging	k l ih ng ih ng
clip	k l ih p
clipped	k l ih p t
clock	k l aa k
clogging	k l aa g ih ng
close	k l ow s
closed	k l ow z d
closely	k l ow s l iy
closer	k l ow s er
closes	k l ow z ih z
closest	k l ow s ah s t
closing	k l ow z ih ng
cloth	k l ao th
clothed	k l ow dh d
clothing	k l ow dh ih ng
cloths	k l ao th s
clouds	k l aw d z
clue	k l uw
clump	k l ah m p
clumps	k l ah m p s
clumsily	k l ah m s ah l iy
clung	k l ah ng
cluster	k l ah s t er
clustered	k l ah s t er d
clutch	k l ah ch
clutched	k l ah ch t
clutches	k l ah ch ah z
clutching	k l ah ch ih ng
coin	k oy n
coincidence	k ow ih n s ih d ah n s
cold	k ow l d
coliseum	k aa l ah s iy ah m
collapse	k ah l ae p s
collapsed	k ah l ae p s t
collect	k ah l eh k t
collected	k ah l eh k t ah d
collecting	k ah l eh k t ih ng
collection	k ah l eh k sh ah n
collision	k ah l ih zh ah n
colossal	k ah l aa s ah l
colour	k ah l er
coloured	k ah l er d
column	k aa l ah m
columns	k aa l ah m z
combat	k aa m b ae t
combatants	k ah m b ae t ah n t s
combats	k ah m b ae t s
combination	k aa m b ah n ey sh ah n
combined	k ah m b ay n d
combing	k ow m ih ng
combustion	k ah m b ah s ch ah n
come	k ah m
comes	k ah m z
coming	k ah m ih ng
command	k ah m ae n d
commanded	k ah m ae n d ih d
commander	k ah m ae n d er
commanders	k ah m ae n d er z
commanding	k ah m ae n d ih ng
commands	k ah m ae n d z
commenced	k ah m eh n s t
commencing	k ah m eh n s ih ng
comment	k aa m eh n t
comments	k aa m eh n t s
committed	k ah m ih t ih d
common	k aa m ah n
commonly	k aa m ah n l iy
commotion	k ah m ow sh ah n
communicate	k ah m y uw n ah k ey t
communication	k ah m y uw n ah k ey sh ah n
communities	k ah m y uw n ah t iy z
community	k ah m y uw n ah t iy
companion	k ah m p ae n y ah n
companions	k ah m p ae n y ah n z
companionship	k ah m p ae n y ah n sh ih p
company	k ah m p ah n iy
comparative	k ah m p ae r ah t ih v
comparatively	k ah m p ae r ah t ih v l iy
compared	k ah m p eh r d
comparison	k ah m p eh r ah s ah n
compartment	k ah m p aa r t m ah n t
compass	k ah m p ah s
compelled	k ah m p eh l d
compelling	k ah m p eh l ih ng
competent	k aa m p ah t ih n t
complete	k ah m p l iy t
completed	k ah m p l iy t ah d
completely	k ah m p l iy t l iy
completes	k ah m p l iy t s
completing	k ah m p l iy t ih ng
complexion	k ah m p l eh k sh ah n
comported	k ah m p ao r t ah d
compose	k ah m p ow z
composed	k ah m p ow z d
composite	k ah m p aa z ah t
composition	k aa m p ah z ih sh ah n
comprehend	k aa m p r iy hh eh n d
comprehension	k aa m p r iy hh eh n sh ah n
compromise	k aa m p r ah m ay z
computed	k ah m p y uw t ah d
comrade	k aa m r ae d
comrades	k aa m r ae d z
conceal	k ah n s iy l
concealed	k ah n s iy l d
concealing	k ah n s iy l ih ng
concealment	k ah n s iy l m ah n t
concede	k ah n s iy d
conceive	k ah n s iy v
conceived	k ah n s iy v d
conception	k ah n s eh p sh ah n
concerned	k ah n s er n d
concerning	k ah n s er n ih ng
concerted	k ah n s er t ah d
conclusion	k ah n k l uw zh ah n
conclusively	k ah n k l uw s ih v l iy
concoction	k ah n k aa k sh ah n
concourse	k aa n k ao r s
concrete	k ah n k r iy t
condemned	k ah n d eh m d
condition	k ah n d ih sh ah n
conditions	k ah n d ih sh ah n z
conduct	k aa n d ah k t
conducted	k ah n d ah k t ah d
cone	k ow n
conference	k aa n f er ah n s
confess	k ah n f eh s
confession	k ah n f eh sh ah n
confidence	k aa n f ah d eh n s
confidences	k aa n f ah d eh n s ih z
confident	k aa n f ah d ah n t
confined	k ah n f ay n d
confinement	k ah n f ay n m ah n t
confines	k aa n f ay n z
confirm	k ah n f er m
confirmed	k ah n f er m d
conflagration	k aa n f l ah g r ey sh ah n
conflict	k aa n f l ih k t
confront	k ah n f r ah n t
confronted	k ah n f r ah n t ah d
confronting	k ah n f r ah n t ih ng
confronts	k ah n f r ah n t s
confuse	k ah n f y uw z
confused	k ah n f y uw z d
confusion	k ah n f y uw zh ah n
congratulated	k ah n g r ae ch ah l ey t ih d
conjecture	k ah n jh eh k ch er
conjunction	k ah n jh ah ng k sh ah n
conjured	k aa n jh er d
connect	k ah n eh k t
connected	k ah n eh k t ih d
connection	k ah n eh k sh ah n
connections	k ah n eh k sh ah n z
connects	k ah n eh k t s
connivance	k ah n ay v ah n s
conquer	k aa ng k er
conquered	k aa ng k er d
conquest	k aa ng k w eh s t
conscious	k aa n sh ah s
consciousness	k aa n sh ah s n ah s
consequences	k aa n s ah k w eh n s ah z
consider	k ah n s ih d er
considerable	k ah n s ih d er ah b ah l
considerably	k ah n s ih d er ah b l iy
considerate	k ah n s ih d er ah t
consideration	k ah n s ih d er ey sh ah n
considered	k ah n s ih d er d
consigned	k ah n s ay n d
consisted	k ah n s ih s t ah d
consistent	k ah n s ih s t ah n t
consisting	k ah n s ih s t ih ng
consists	k ah n s ih s t s
conspicuous	k ah n s p ih k y uw ah s
constant	k aa n s t ah n t
constantly	k aa n s t ah n t l iy
constellations	k aa n s t ah l ey sh ah n z
consternation	k aa n s t er n ey sh ah n
constituted	k aa n s t ah t uw t ah d
constitutes	k aa n s t ah t uw t s
constructed	k ah n s t r ah k t ah d
construction	k ah n s t r ah k sh ah n
contact	k aa n t ae k t
contain	k ah n t ey n
contained	k ah n t ey n d
containing	k ah n t ey n ih ng
contains	k ah n t ey n z
contaminate	k ah n t ae m ah n ey t
contemplated	k aa n t ah m p l ey t ih d
contemplation	k aa n t ah m p l ey sh ah n
contempt	k ah n t eh m p t
contending	k ah n t eh n d ih ng
contest	k aa n t eh s t
contiguous	k ah n t ih g y uw ah s
continual	k ah n t ih n y uw ah l
continuation	k ah n t ih n y uw ey sh ah n
continue	k ah n t ih n y uw
continued	k ah n t ih n y uw d
continuous	k ah n t ih n y uw ah s
continuously	k ah n t ih n y uw ah s l iy
contorted	k ah n t ao r t ah d
contortions	k ah n t ao r sh ah n z
contrast	k aa n t r ae s t
contravention	k aa n t r ah v eh n ch ah n
contrived	k ah n t r ay v d
control	k ah n t r ow l
controlled	k ah n t r ow l d
controlling	k ah n t r ow l ih ng
controls	k ah n t r ow l z
converging	k ah n v er jh ih ng
conversation	k aa n v er s ey sh ah n
conversational	k aa n v er s ey sh ah n ah l
convey	k ah n v ey
conveyed	k ah n v ey d
convictions	k ah n v ih k sh ah n z
convince	k ah n v ih n s
convinced	k ah n v ih n s t
convoy	k aa n v oy
convoys	k aa n v oy z
convulsions	k ah n v ah l sh ah n z
cool	k uw l
cope	k ow p
copies	k aa p iy z
copper	k aa p er
copy	k aa p iy
cord	k ao r d
cordial	k ao r jh ah l
cordon	k ao r d ah n
corner	k ao r n er
corpse	k ao r p s
corpses	k ao r p s ah z
corralled	k er ae l d
corresponds	k ao r ah s p aa n d z
corridor	k ao r ah d er
corridors	k ao r ih d er z
corroborate	k er aa b er ey t
costly	k aa s t l iy
cottage	k aa t ah jh
cotton	k aa t ah n
couch	k aw ch
couched	k aw ch t
could	k uh d
council	k aw n s ah l
councils	k aw n s ih l z
count	k aw n t
counted	k aw n t ih d
countenance	k aw n t ah n ah n s
countercharge	k aw n t er ch aa r jh
counterpart	k aw n t er p aa r t
counting	k aw n t ih ng
countless	k aw n t l ah s
countries	k ah n t r iy z
country	k ah n t r iy
countryman	k ah n t r iy m ah n
counts	k aw n t s
coup	k uw
couple	k ah p ah l
coupled	k ah p ah l d
courage	k er ih jh
courageous	k er ey jh ah s
course	k ao r s
courses	k ao r s ah z
coursing	k ao r s ih ng
court	k ao r t
courted	k ao r t ih d
courteous	k er t iy ah s
courtesy	k er t ah s iy
courtier	k ao r t iy er
courts	k ao r t s
courtyard	k ao r t y aa r d
courtyards	k ao r t y aa r d z
cover	k ah v er
covered	k ah v er d
covering	k ah v er ih ng
covers	k ah v er z
coveted	k ah v ah t ih d
covets	k ah v ah t s
coward	k aw er d
cowardly	k aw er d l iy
cowards	k aw er d z
cowed	k aw d
crack	k r ae k
cracked	k r ae k t
craft	k r ae f t
crafty	k r ae f t iy
cranny	k r ae n iy
crash	k r ae sh
crashed	k r ae sh t
crashing	k r ae sh ih ng
crave	k r ey v
craven	k r ey v ah n
crawl	k r ao l
crawled	k r ao l d
crawling	k r ao l ih ng
crazed	k r ey z d
crazy	k r ey z iy
create	k r iy ey t
created	k r iy ey t ah d
creature	k r iy ch er
creatures	k r iy ch er z
credence	k r iy d ah n s
credible	k r eh d ah b ah l
credit	k r eh d ah t
credited	k r eh d ah t ah d
credulous	k r eh jh ah l ah s
creed	k r iy d
creeping	k r iy p ih ng
crept	k r eh p t
crest	k r eh s t
crevice	k r eh v ah s
crew	k r uw
crews	k r uw z
cried	k r ay d
cries	k r ay z
crime	k r ay m
criminal	k r ih m ah n ah l
crimson	k r ih m z ah n
cropped	k r aa p t
cropping	k r aa p ih ng
cross	k r ao s
crossbow	k r ao s b ow
crossed	k r ao s t
crosses	k r ao s ih z
crossing	k r ao s ih ng
crouched	k r aw ch t
crowd	k r aw d
crowded	k r aw d ah d
crowding	k r aw d ih ng
crowds	k r aw d z
crowned	k r aw n d
crude	k r uw d
cruel	k r uw ah l
cruelties	k r uw l t iy z
cruelty	k r uw l t iy
cruiser	k r uw z er
cruisers	k r uw z er z
crumple	k r ah m p ah l
crumpled	k r ah m p ah l d
crushed	k r ah sh t
crust	k r ah s t
cry	k r ay
crying	k r ay ih ng
cult	k ah l t
cultivation	k ah l t ih v ey sh ah n
cultured	k ah l ch er d
cunning	k ah n ih ng
curiosity	k y uh r iy aa s ah t iy
curious	k y uh r iy ah s
curled	k er l d
curse	k er s
cursed	k er s t
curses	k er s ih z
cursing	k er s ih ng
cursory	k er s er iy
curtain	k er t ah n
curved	k er v d
cushion	k uh sh ah n
custodian	k ah s t ow d iy ah n
custody	k ah s t ah d iy
custom	k ah s t ah m
customary	k ah s t ah m eh r iy
customs	k ah s t ah m z
cut	k ah t
cuts	k ah t s
cutting	k ah t ih ng
cycle	s ay k ah l
dagger	d ae g er
daggers	d ae g er z
daily	d ey l iy
dais	d ey z
damage	d ae m ah jh
damnation	d ae m n ey sh ah n
damned	d ae m d
damp	d ae m p
damsel	d ae m z ah l
danger	d ey n jh er
dangerous	d ey n jh er ah s
dangers	d ey n jh er z
dangled	d ae ng g ah l d
dangling	d ae ng g ah l ih ng
dante	d aa n t ey
dare	d eh r
dared	d eh r d
dares	d eh r z
dark	d aa r k
darkness	d aa r k n ah s
darting	d aa r t ih ng
dash	d ae sh
dashed	d ae sh t
dashing	d ae sh ih ng
data	d ey t ah
date	d ey t
daughter	d ao t er
daughters	d ao t er z
dawn	d ao n
dawning	d ao n ih ng
day	d ey
daylight	d ey l ay t
days	d ey z
dazzling	d ae z ah l ih ng
dead	d eh d
deadly	d eh d l iy
deafening	d eh f ah n ih ng
deal	d iy l
dealt	d eh l t
dear	d ih r
dearly	d ih r l iy
death	d eh th
deathly	d eh th l iy
deaths	d eh th s
debated	d ah b ey t ih d
debris	d ah b r iy
deceived	d ih s iy v d
deception	d ih s eh p sh ah n
decided	d ih s ay d ih d
decision	d ih s ih zh ah n
deck	d eh k
decked	d eh k t
decks	d eh k s
declare	d ih k l eh r
declining	d ih k l ay n ih ng
decorated	d eh k er ey t ah d
decrease	d ih k r iy s
decree	d ih k r iy
decrees	d ih k r iy z
deductions	d ih d ah k sh ah n z
deed	d iy d
deeds	d iy d z
deep	d iy p
deeper	d iy p er
deepest	d iy p ah s t
deeply	d iy p l iy
defamed	d ih f ey m d
defeat	d ih f iy t
defeated	d ih f iy t ah d
defence	d ih f eh n s
defend	d ih f eh n d
defendant	d ih f eh n d ah n t
defended	d ih f eh n d ah d
defending	d ih f eh n d ih ng
defied	d ih f ay d
defined	d ih f ay n d
deflected	d ih f l eh k t ih d
deformed	d ih f ao r m d
defy	d ih f ay
degradation	d eh g r ah d ey sh ah n
degraded	d ih g r ey d ah d
degree	d ih g r iy
degrees	d ih g r iy z
deign	d ey n
deity	d iy ah t iy
delay	d ih l ey
deliberately	d ih l ih b er ah t l iy
deliberation	d ih l ih b er ey sh ah n
delicate	d eh l ah k ah t
delight	d ih l ay t
delights	d ih l ay t s
deliver	d ih l ih v er
delivered	d ih l ih v er d
delivery	d ih l ih v er iy
deluded	d ih l uw d ih d
demand	d ih m ae n d
demanded	d ih m ae n d ah d
demean	d ih m iy n
demons	d iy m ah n z
demonstration	d eh m ah n s t r ey sh ah n
demonstrations	d eh m ah n s t r ey sh ah n z
demoralization	d ih m ao r ah l ih z ey sh ah n
denizens	d eh n ah z ah n z
denoted	d ih n ow t ah d
denotes	d ih n ow t s
dense	d eh n s
denuded	d ih n uw d ih d
deny	d ih n ay
departed	d ih p aa r t ih d
depend	d ih p eh n d
depended	d ih p eh n d ah d
deposited	d ah p aa z ih t ih d
depressed	d ih p r eh s t
depression	d ih p r eh sh ah n
deprived	d ih p r ay v d
depth	d eh p th
depths	d eh p th s
derive	d er ay v
descend	d ih s eh n d
descended	d ih s eh n d ah d
descending	d ih s eh n d ih ng
descent	d ih s eh n t
describe	d ih s k r ay b
described	d ih s k r ay b d
describing	d ih s k r ay b ih ng
description	d ih s k r ih p sh ah n
desecrate	d eh z ah k r ey t
desert	d eh z er t
deserted	d ih z er t ih d
deserts	d eh z er t s
deserved	d ih z er v d
design	d ih z ay n
designs	d ih z ay n z
desirable	d ih z ay r ah b ah l
desire	d ih z ay er
desired	d ih z ay er d
desires	d ih z ay er z
desist	d ih s ih s t
desolate	d eh s ah l ah t
despair	d ih s p eh r
despairing	d ih s p eh r ih ng
desperate	d eh s p r ih t
despite	d ih s p ay t
destination	d eh s t ah n ey sh ah n
destined	d eh s t ih n d
destroy	d ih s t r oy
destroyed	d ih s t r oy d
destroyers	d ih s t r oy er z
destruction	d ih s t r ah k sh ah n
destructive	d ih s t r ah k t ih v
detach	d ih t ae ch
detail	d ih t ey l
detailed	d ih t ey l d
details	d ih t ey l z
detaining	d ih t ey n ih ng
detect	d ih t eh k t
detected	d ih t eh k t ah d
detection	d ih t eh k sh ah n
determination	d ih t er m ah n ey sh ah n
determine	d ah t er m ah n
determined	d ih t er m ah n d
detract	d ih t r ae k t
detracts	d ih t r ae k t s
deuce	d uw s
developed	d ih v eh l ah p t
development	d ih v eh l ah p m ah n t
device	d ih v ay s
devices	d ih v ay s ah z
devil	d eh v ah l
devils	d eh v ah l z
devious	d iy v iy ah s
devise	d ih v ay z
devoid	d ih v oy d
devolved	d ih v aa l v d
devote	d ih v ow t
devoted	d ih v ow t ah d
devotion	d ih v ow sh ah n
devoured	d ih v aw er d
devouring	d ih v aw er ih ng
dews	d uw z
diadem	d ay ah d eh m
diameter	d ay ae m ah t er
diamond	d ay m ah n d
diamonds	d ay m ah n d z
dictated	d ih k t ey t ih d
dictates	d ih k t ey t s
did	d ih d
die	d ay
died	d ay d
dies	d ay z
differ	d ih f er
difference	d ih f er ah n s
different	d ih f er ah n t
difficult	d ih f ah k ah l t
difficulties	d ih f ah k ah l t iy z
difficulty	d ih f ah k ah l t iy
diffuse	d ih f y uw s
diffused	d ih f y uw z d
dignified	d ih g n ah f ay d
dignitaries	d ih g n ah t eh r iy z
dilemma	d ih l eh m ah
dim	d ih m
dimensions	d ih m eh n sh ah n z
diminished	d ih m ih n ih sh t
diminishing	d ih m ih n ih sh ih ng
dimly	d ih m l iy
din	d ih n
dine	d ay n
diners	d ay n er z
dining	d ay n ih ng
dinner	d ih n er
dipping	d ih p ih ng
dips	d ih p s
dire	d ay r
direct	d er eh k t
directed	d er eh k t ah d
directing	d er eh k t ih ng
direction	d er eh k sh ah n
directions	d er eh k sh ah n z
directly	d er eh k t l iy
dirt	d er t
disabled	d ih s ey b ah l d
disappear	d ih s ah p ih r
disappearance	d ih s ah p ih r ah n s
disappeared	d ih s ah p ih r d
disappearing	d ih s ah p ih r ih ng
disappears	d ih s ah p ih r z
disappointed	d ih s ah p oy n t ih d
disappointing	d ih s ah p oy n t ih ng
disappointment	d ih s ah p oy n t m ah n t
disarmed	d ih s aa r m d
disarming	d ih s aa r m ih ng
disaster	d ih z ae s t er
disasters	d ih z ae s t er z
discern	d ih s er n
discerned	d ih s er n d
discharge	d ih s ch aa r jh
discipline	d ih s ah p l ah n
disclosed	d ih s k l ow z d
disclosing	d ih s k l ow z ih ng
discouraged	d ih s k er ih jh d
discourse	d ih s k ao r s
discover	d ih s k ah v er
discovered	d ih s k ah v er d
discovers	d ih s k ah v er z
discovery	d ih s k ah v er iy
discreet	d ih s k r iy t
discuss	d ih s k ah s
discussed	d ih s k ah s t
disengaged	d ih s ih n g ey jh d
disgrace	d ih s g r ey s
disguise	d ih s g ay z
disguised	d ih s g ay z d
disgust	d ih s g ah s t
disgusted	d ih s g ah s t ah d
disgusting	d ih s g ah s t ih ng
dishonorable	d ih s aa n er ah b ah l
disillusionment	d ih s ih l uw zh ah n m ah n t
disintegration	d ih s ih n t ah g r ey sh ah n
dislike	d ih s l ay k
disliked	d ih s l ay k t
dislodged	d ih s l aa jh d
disloyalty	d ih s l oy ah l t iy
dismay	d ih s m ey
disobeyed	d ih s ow b ey d
disorder	d ih s ao r d er
dispatch	d ih s p ae ch
dispatched	d ih s p ae ch t
dispatches	d ih s p ae ch ih z
dispatching	d ih s p ae ch ih ng
disperse	d ih s p er s
displease	d ih s p l iy z
disposal	d ih s p ow z ah l
disposed	d ih s p ow z d
disrespect	d ih s r ih s p eh k t
dissipated	d ih s ah p ey t ih d
dissolve	d ih z aa l v
distance	d ih s t ah n s
distances	d ih s t ah n s ah z
distant	d ih s t ah n t
distasteful	d ih s t ey s t f ah l
distinct	d ih s t ih ng k t
distinctive	d ih s t ih ng k t ih v
distinctly	d ih s t ih ng k t l iy
distinguish	d ih s t ih ng g w ih sh
distorted	d ih s t ao r t ah d
distract	d ih s t r ae k t
distracted	d ih s t r ae k t ah d
distributed	d ih s t r ih b y ah t ah d
district	d ih s t r ih k t
disturbance	d ih s t er b ah n s
dive	d ay v
dived	d ay v d
diverged	d ay v er jh d
diverging	d ay v er jh ih ng
diversion	d ay v er zh ah n
dives	d ay v z
divide	d ih v ay d
divided	d ih v ay d ih d
divine	d ih v ay n
divinely	d ih v ay n l iy
divinity	d ih v ih n ah t iy
division	d ih v ih zh ah n
divulge	d ih v ah l jh
dizzy	d ih z iy
do	d uw
dock	d aa k
docks	d aa k s
doctrine	d aa k t r ah n
does	d ah z
dog	d ao g
dogs	d aa g z
doing	d uw ih ng
dollar	d aa l er
domain	d ow m ey n
domains	d ow m ey n z
dome	d ow m
dominant	d aa m ah n ah n t
don	d aa n
done	d ah n
doom	d uw m
doomed	d uw m d
door	d ao r
doors	d ao r z
doorway	d ao r w ey
doorways	d ao r w ey z
dorado	d ao r aa d ow
dotted	d aa t ah d
double	d ah b ah l
doubt	d aw t
doubted	d aw t ih d
doubtful	d aw t f ah l
doubtless	d aw t l ah s
doubts	d aw t s
doughty	d ao t iy
down	d aw n
downward	d aw n w er d
dozen	d ah z ah n
dozing	d ow z ih ng
drag	d r ae g
dragged	d r ae g d
dragging	d r ae g ih ng
drags	d r ae g z
drained	d r ey n d
draped	d r ey p t
draught	d r ae f t
draw	d r ao
drawing	d r ao ih ng
drawn	d r ao n
dread	d r eh d
dreaded	d r eh d ih d
dream	d r iy m
dreamed	d r iy m d
dreary	d r ih r iy
dress	d r eh s
drew	d r uw
dried	d r ay d
drifted	d r ih f t ah d
drifting	d r ih f t ih ng
drink	d r ih ng k
drinking	d r ih ng k ih ng
dripping	d r ih p ih ng
drive	d r ay v
driven	d r ih v ah n
droll	d r ow l
drone	d r ow n
drooped	d r uw p t
drop	d r aa p
dropped	d r aa p t
dropping	d r aa p ih ng
drown	d r aw n
drowned	d r aw n d
drunk	d r ah ng k
ducked	d ah k t
due	d uw
duel	d uw ah l
duels	d uw ah l z
dues	d uw z
dug	d ah g
dull	d ah l
dumbfounded	d ah m f aw n d ih d
dungeon	d ah n jh ah n
dungeons	d ah n jh ah n z
duplicate	d uw p l ah k ah t
duplicated	d uw p l ih k ey t ih d
duration	d uh r ey sh ah n
during	d uh r ih ng
dust	d ah s t
duties	d uw t iy z
duty	d uw t iy
dwarf	d w ao r f
dwell	d w eh l
dwindled	d w ih n d ah l d
dying	d ay ih ng
e	iy
each	iy ch
ear	iy r
earlier	er l iy er
early	er l iy
earmarks	ih r m aa r k s
earned	er n d
earnest	er n ih s t
ears	ih r z
earth	er th
earthly	er th l iy
ease	iy z
easier	iy z iy er
easiest	iy z iy ah s t
easily	iy z ah l iy
east	iy s t
eastern	iy s t er n
easy	iy z iy
eat	iy t
eaten	iy t ah n
eating	iy t ih ng
eats	iy t s
ebbing	eh b ih ng
ebony	eh b ah n iy
echo	eh k ow
echoed	eh k ow d
echoes	eh k ow z
eclipse	ih k l ih p s
ecstasy	eh k s t ah s iy
eddies	eh d iy z
edge	eh jh
edged	eh jh d
edict	iy d ih k t
edification	eh d ah f ah k ey sh ah n
effect	ih f eh k t
effected	ih f eh k t ah d
effective	ih f eh k t ih v
effects	ih f eh k t s
effort	eh f er t
efforts	eh f er t s
egg	eh g
eggshell	eh g sh eh l
egress	ih g r eh s
eight	ey t
eighty	ey t iy
either	iy dh er
el	eh l
elapsed	ih l ae p s t
elation	ih l ey sh ah n
elbow	eh l b ow
elect	ih l eh k t
electrical	ih l eh k t r ih k ah l
element	eh l ah m ah n t
elephant	eh l ah f ah n t
elevator	eh l ah v ey t er
elicited	ih l ih s ih t ih d
eloquent	eh l ah k w ah n t
else	eh l s
elsewhere	eh l s w eh r
elude	ih l uw d
eluded	ih l uw d ih d
eluding	ih l uw d ih ng
emaciated	ih m ey sh iy ey t ih d
emanate	eh m ah n ey t
emanates	eh m ah n ey t s
emancipation	ih m ae n s ah p ey sh ah n
embark	eh m b aa r k
embarked	eh m b aa r k t
embarrassed	ih m b eh r ah s t
embrace	eh m b r ey s
embraced	eh m b r ey s t
emerald	eh m r ah l d
emerge	ih m er jh
emerged	ih m er jh d
emerges	ih m er jh ih z
emerging	ih m er jh ih ng
eminence	eh m ah n ah n s
emitted	ih m ih t ah d
emotion	ih m ow sh ah n
emotions	ih m ow sh ah n z
emphasized	eh m f ah s ay z d
empire	eh m p ay er
empty	eh m p t iy
emptying	eh m p t iy ih ng
enabled	eh n ey b ah l d
enacted	eh n ae k t ah d
enchanted	eh n ch ae n t ih d
enchanting	eh n ch ae n t ih ng
encircled	ih n s er k ah l d
enclosure	eh n k l ow zh er
encompassed	eh n k ah m p ah s t
encountered	ih n k aw n t er d
encourage	eh n k er ih jh
encouragement	eh n k er ih jh m ah n t
encrusted	eh n k r ah s t ih d
end	eh n d
endeavour	ih n d eh v er
ended	eh n d ah d
ending	eh n d ih ng
endless	eh n d l ah s
endowed	eh n d aw d
ends	eh n d z
endure	eh n d y uh r
endured	eh n d y uh r d
enduring	eh n d y uh r ih ng
enemies	eh n ah m iy z
enemy	eh n ah m iy
energy	eh n er jh iy
engage	ih n g ey jh
engaged	ih n g ey jh d
engender	eh n jh eh n d er
engine	eh n jh ah n
engines	eh n jh ah n z
english	ih ng g l ih sh
engrossed	ih n g r ow s t
engulf	ih n g ah l f
engulfed	ih n g ah l f t
engulfing	ih n g ah l f ih ng
enhanced	eh n hh ae n s t
enjoy	eh n jh oy
enjoyment	eh n jh oy m ah n t
enlist	eh n l ih s t
enlisted	eh n l ih s t ih d
enmity	eh n m ah t iy
enormous	ih n ao r m ah s
enough	ih n ah f
enshrouded	ih n sh r aw d ah d
enter	eh n t er
entered	eh n t er d
entering	eh n t er ih ng
enters	eh n t er z
entertain	eh n t er t ey n
entertained	eh n t er t ey n d
entertainment	eh n t er t ey n m ah n t
enthralled	eh n th r ao l d
enthusiastic	ih n th uw z iy ae s t ih k
entire	ih n t ay er
entirely	ih n t ay er l iy
entitled	eh n t ay t ah l d
entrails	eh n t r ah l z
entrance	eh n t r ah n s
entrances	eh n t r ah n s ah z
entry	eh n t r iy
enveloped	eh n v eh l ah p t
envied	eh n v iy d
environment	ih n v ay r ah n m ah n t
envy	eh n v iy
equal	iy k w ah l
equally	iy k w ah l iy
equator	ih k w ey t er
equipment	ih k w ih p m ah n t
equipped	ih k w ih p t
equipping	ih k w ih p ih ng
equivalent	ih k w ih v ah l ah n t
eradicated	ih r ae d ah k ey t ih d
ere	eh r
erect	ih r eh k t
erected	ih r eh k t ah d
erroneous	eh r ow n iy ah s
error	eh r er
erstwhile	er s t w ay l
escape	ih s k ey p
escaped	ih s k ey p t
escapes	ih s k ey p s
escaping	ih s k ey p ih ng
escarpment	eh s k aa r p m ah n t
escort	eh s k ao r t
escorted	eh s k ao r t ih d
escorting	eh s k ao r t ih ng
especially	ah s p eh sh l iy
espouse	ih s p aw z
estate	eh s t ey t
esteem	eh s t iy m
estimate	eh s t ah m ah t
estimated	eh s t ah m ey t ah d
estimation	eh s t ah m ey sh ah n
eternal	ih t er n ah l
eternally	ih t er n ah l iy
eternity	ih t er n ah t iy
ethics	eh th ih k s
even	iy v ih n
evening	iy v n ih ng
evenly	iy v ah n l iy
event	ih v eh n t
events	ih v eh n t s
eventual	ah v eh n ch uw ah l
eventually	ih v eh n ch ah w ah l iy
ever	eh v er
evermore	eh v er m ao r
every	eh v er iy
everything	eh v r iy th ih ng
everywhere	eh v r iy w eh r
evidence	eh v ah d ah n s
evidenced	eh v ih d ah n s t
evidences	eh v ah d ah n s ah z
evident	eh v ah d ah n t
evidently	eh v ah d ah n t l iy
evil	iy v ah l
evinced	ih v ih n s t
evolution	eh v ah l uw sh ah n
evolved	ih v aa l v d
exact	ih g z ae k t
examination	ih g z ae m ah n ey sh ah n
examine	ih g z ae m ih n
examined	ih g z ae m ah n d
example	ih g z ae m p ah l
excavation	eh k s k ah v ey sh ah n
exceeded	ih k s iy d ah d
excellent	eh k s ah l ah n t
except	ih k s eh p t
exception	ih k s eh p sh ah n
exchange	ih k s ch ey n jh
exchanged	ih k s ch ey n jh d
excited	ih k s ay t ah d
excitedly	ih k s ay t ah d l iy
excitement	ih k s ay t m ah n t
exclaimed	ih k s k l ey m d
exclamation	eh k s k l ah m ey sh ah n
exclamations	eh k s k l ah m ey sh ah n z
excuse	ih k s k y uw s
excused	ih k s k y uw z d
execute	eh k s ah k y uw t
execution	eh k s ah k y uw sh ah n
executioner	eh k s ah k y uw sh ah n er
exertion	ih g z er sh ah n
exhausted	ih g z ao s t ih d
exhaustion	ih g z ao s ch ah n
exhibition	eh k s ah b ih sh ah n
exhortation	eh g z ao r t ey sh ah n
exist	ih g z ih s t
existed	ih g z ih s t ah d
existence	eh g z ih s t ah n s
exit	eh g z ih t
expanse	ih k s p ae n s
expect	ih k s p eh k t
expectancy	ih k s p eh k t ah n s iy
expectant	ih k s p eh k t ah n t
expected	ih k s p eh k t ah d
expecting	ih k s p eh k t ih ng
expedition	eh k s p ah d ih sh ah n
expeditions	eh k s p ah d ih sh ah n z
experience	ih k s p ih r iy ah n s
experienced	ih k s p ih r iy ah n s t
experiences	ih k s p ih r iy ah n s ih z
expiration	eh k s p er ey sh ah n
explain	ih k s p l ey n
explained	ih k s p l ey n d
explanation	eh k s p l ah n ey sh ah n
exploded	ih k s p l ow d ah d
explore	ih k s p l ao r
explored	ih k s p l ao r d
exploring	ih k s p l ao r ih ng
explosion	ih k s p l ow zh ah n
exposure	ih k s p ow zh er
expressed	ih k s p r eh s t
expression	ih k s p r eh sh ah n
expressions	ih k s p r eh sh ah n z
exquisite	eh k s k w ah z ah t
extend	ih k s t eh n d
extended	ih k s t eh n d ah d
extending	ih k s t eh n d ih ng
extensively	ih k s t eh n s ih v l iy
extent	ih k s t eh n t
extermination	ih k s t er m ah n ey sh ah n
extinction	ih k s t ih ng k sh ah n
extinguish	ih k s t ih ng g w ih sh
extinguished	ih k s t ih ng g w ih sh t
extinguishing	ih k s t ih ng g w ih sh ih ng
extreme	ih k s t r iy m
extremely	ih k s t r iy m l iy
extremities	eh k s t r eh m ah t iy z
extremity	eh k s t r eh m ah t iy
eye	ay
eyeball	ay b ao l
eyed	ay d
eyeing	ay ih ng
eyes	ay z
eyesight	ay s ay t
fabled	f ey b ah l d
fabric	f ae b r ih k
fabulous	f ae b y ah l ah s
face	f ey s
faced	f ey s t
faces	f ey s ah z
facing	f ey s ih ng
fact	f ae k t
factions	f ae k sh ah n z
factor	f ae k t er
facts	f ae k t s
faculties	f ae k ah l t iy z
faded	f ey d ah d
fail	f ey l
failed	f ey l d
failure	f ey l y er
faint	f ey n t
fainter	f ey n t er
faintest	f ey n t ah s t
fainting	f ey n t ih ng
faintly	f ey n t l iy
fair	f eh r
fairer	f eh r er
fairest	f eh r ih s t
fairly	f eh r l iy
fairyland	f eh r iy l ae n d
faith	f ey th
faithful	f ey th f ah l
fall	f ao l
fallacy	f ae l ah s iy
fallen	f aa l ah n
falling	f aa l ih ng
falls	f ao l z
false	f ao l s
falsehoods	f ae l s hh uh d z
familiar	f ah m ih l y er
familiarity	f ah m ih l y eh r ah t iy
familiarized	f ah m ih l y er ay z d
family	f ae m ah l iy
famished	f ae m ih sh t
famous	f ey m ah s
fanaticism	f ah n ae t ah s ih z ah m
fanatics	f ah n ae t ih k s
fancied	f ae n s iy d
fanciful	f ae n s ih f ah l
fangs	f ae ng z
far	f aa r
fare	f eh r
farewell	f eh r w eh l
farm	f aa r m
farther	f aa r dh er
farthest	f aa r dh ah s t
fascinated	f ae s ah n ey t ah d
fascinating	f ae s ah n ey t ih ng
fashion	f ae sh ah n
fashioned	f ae sh ah n d
fast	f ae s t
fasten	f ae s ah n
fastened	f ae s ah n d
fastening	f ae s ah n ih ng
faster	f ae s t er
fastest	f ae s t ah s t
fatal	f ey t ah l
fate	f ey t
father	f aa dh er
fathers	f aa dh er z
fathom	f ae dh ah m
favour	f ey v er
fealty	f iy ah l t iy
fear	f ih r
feared	f ih r d
fearful	f ih r f ah l
fearing	f ih r ih ng
fears	f ih r z
fearsome	f ih r s ah m
feast	f iy s t
feature	f iy ch er
features	f iy ch er z
fed	f eh d
feed	f iy d
feeding	f iy d ih ng
feel	f iy l
feeling	f iy l ih ng
feelings	f iy l ih ng z
feet	f iy t
feigned	f ey n d
fell	f eh l
felled	f eh l d
fellow	f eh l ow
fellows	f eh l ow z
felon	f eh l ah n
felt	f eh l t
female	f iy m ey l
females	f iy m ey l z
ferocious	f er ow sh ah s
ferociously	f er ow sh ih s l iy
ferocity	f er aa s ah t iy
fertile	f er t ah l
fervent	f er v ah n t
festering	f eh s t er ih ng
festival	f eh s t ah v ah l
fetch	f eh ch
fetching	f eh ch ih ng
fete	f ey t
fettered	f eh t er d
fetters	f eh t er z
fever	f iy v er
feverishly	f eh v er ih sh l iy
few	f y uw
fewer	f y uw er
fiasco	f iy ae s k ow
field	f iy l d
fiend	f iy n d
fiendish	f iy n d ih sh
fiends	f iy n d z
fierce	f ih r s
fiercely	f ih r s l iy
fiercer	f ih r s er
fiery	f ay er iy
fifteen	f ih f t iy n
fifth	f ih f th
fifty	f ih f t iy
fight	f ay t
fighter	f ay t er
fighters	f ay t er z
fighting	f ay t ih ng
fights	f ay t s
figure	f ih g y er
figures	f ih g y er z
filed	f ay l d
filing	f ay l ih ng
fill	f ih l
filled	f ih l d
filling	f ih l ih ng
filtered	f ih l t er d
final	f ay n ah l
finally	f ay n ah l iy
find	f ay n d
finds	f ay n d z
fine	f ay n
finest	f ay n ah s t
finger	f ih ng g er
fingers	f ih ng g er z
finish	f ih n ih sh
finished	f ih n ih sh t
fire	f ay er
firearm	f ay er aa r m
firearms	f ay er aa r m z
fired	f ay er d
firing	f ay r ih ng
firm	f er m
firmly	f er m l iy
first	f er s t
fist	f ih s t
fit	f ih t
fits	f ih t s
fitted	f ih t ah d
fitter	f ih t er
fittest	f ih t ah s t
fitting	f ih t ih ng
fittingly	f ih t ih ng l iy
five	f ay v
fix	f ih k s
fixed	f ih k s t
flagging	f l ae g ih ng
flagship	f l ae g sh ih p
flame	f l ey m
flames	f l ey m z
flaming	f l ey m ih ng
flank	f l ae ng k
flanked	f l ae ng k t
flash	f l ae sh
flashed	f l ae sh t
flashes	f l ae sh ih z
flat	f l ae t
flatter	f l ae t er
fled	f l eh d
fledged	f l eh jh d
flee	f l iy
fleeing	f l iy ih ng
fleet	f l iy t
fleeting	f l iy t ih ng
fleets	f l iy t s
flesh	f l eh sh
flew	f l uw
flicker	f l ih k er
flickering	f l ih k er ih ng
flier	f l ay er
fliers	f l ay er z
flight	f l ay t
flint	f l ih n t
flitting	f l ih t ih ng
float	f l ow t
floated	f l ow t ah d
floating	f l ow t ih ng
flood	f l ah d
flooded	f l ah d ah d
floor	f l ao r
flooring	f l ao r ih ng
floors	f l ao r z
floundered	f l aw n d er d
flourished	f l er ih sh t
flowed	f l ow d
flower	f l aw er
flowering	f l aw er ih ng
flowing	f l ow ih ng
flown	f l ow n
flows	f l ow z
flung	f l ah ng
flush	f l ah sh
flushed	f l ah sh t
fly	f l ay
flying	f l ay ih ng
foam	f ow m
foe	f ow
foes	f ow z
fog	f aa g
foisted	f oy s t ih d
foliage	f ow l ih jh
folk	f ow k
follow	f aa l ow
followed	f aa l ow d
followers	f aa l ow er z
following	f aa l ow ih ng
follows	f aa l ow z
food	f uw d
fool	f uw l
foolish	f uw l ih sh
fools	f uw l z
foot	f uh t
foothills	f uh t hh ih l z
foothold	f uh t hh ow l d
footing	f uh t ih ng
footsteps	f uh t s t eh p s
for	f ao r
forbidding	f er b ih d ih ng
force	f ao r s
forced	f ao r s t
forces	f ao r s ih z
forcing	f ao r s ih ng
forebears	f ao r b eh r z
foreboding	f ao r b ow d ih ng
forehead	f ao r hh eh d
foreheads	f ao r hh eh d z
foreman	f ao r m ah n
foremost	f ao r m ow s t
foresee	f ao r s iy
forest	f ao r ah s t
forestalling	f ao r s t aa l ih ng
forests	f ao r ah s t s
foreword	f ao r w er d
forged	f ao r jh d
forget	f er g eh t
forging	f ao r jh ih ng
forgive	f er g ih v
forgotten	f er g aa t ah n
forlorn	f er l ao r n
form	f ao r m
formal	f ao r m ah l
formally	f ao r m ah l iy
formation	f ao r m ey sh ah n
formed	f ao r m d
former	f ao r m er
formerly	f ao r m er l iy
formidable	f ao r m ah d ah b ah l
forming	f ao r m ih ng
forms	f ao r m z
formulated	f ao r m y ah l ey t ah d
forth	f ao r th
forthwith	f ao r th w ih th
fortifications	f ao r t ah f ah k ey sh ah n z
fortified	f ao r t ah f ay d
fortress	f ao r t r ah s
fortresses	f ao r t r ah s ih z
fortunate	f ao r ch ah n ah t
fortunately	f ao r ch ah n ah t l iy
fortune	f ao r ch ah n
fortunes	f ao r ch ah n z
forty	f ao r t iy
forward	f ao r w er d
foster	f aa s t er
fostered	f aa s t er d
fought	f ao t
foul	f aw l
found	f aw n d
four	f ao r
fours	f ao r z
fourteen	f ao r t iy n
fourth	f ao r th
fraction	f r ae k sh ah n
fractious	f r ae k sh ah s
fragments	f r ae g m ah n t s
frail	f r ey l
frame	f r ey m
frantic	f r ae n t ih k
frantically	f r ae n t ah k ah l iy
fraud	f r ao d
fray	f r ey
freaks	f r iy k s
free	f r iy
freed	f r iy d
freedom	f r iy d ah m
freezes	f r iy z ih z
frenzied	f r eh n z iy d
frenzy	f r eh n z iy
frequent	f r iy k w ah n t
fresh	f r eh sh
fretting	f r eh t ih ng
friend	f r eh n d
friendly	f r eh n d l iy
friends	f r eh n d z
friendship	f r eh n d sh ih p
fright	f r ay t
frighten	f r ay t ah n
frightened	f r ay t ah n d
frightful	f r ay t f ah l
fro	f r ow
from	f r ah m
front	f r ah n t
frontier	f r ah n t ih r
froth	f r ao th
frowning	f r aw n ih ng
froze	f r ow z
frozen	f r ow z ah n
fruit	f r uw t
fruitless	f r uw t l ah s
fugitive	f y uw jh ah t ih v
fugitives	f y uw jh ih t ih v z
fulfilled	f uh l f ih l d
full	f uh l
fully	f uh l iy
fume	f y uw m
fumes	f y uw m z
fun	f ah n
functionaries	f ah ng k sh ah n eh r iy z
fund	f ah n d
fur	f er
furious	f y uh r iy ah s
furiously	f y uh r iy ah s l iy
furnish	f er n ih sh
furniture	f er n ih ch er
furs	f er z
further	f er dh er
furthest	f er th ah s t
furtive	f er t ih v
fury	f y uh r iy
fusillade	f y uw s ih l ey d
futile	f y uw t ah l
futility	f y uw t ih l ah t iy
future	f y uw ch er
gag	g ae g
gain	g ey n
gained	g ey n d
gaining	g ey n ih ng
gait	g ey t
gallant	g ae l ah n t
galleries	g ae l er iy z
gallery	g ae l er iy
galling	g ao l ih ng
galloping	g ae l ah p ih ng
gama	g aa m ah
games	g ey m z
gaping	g ey p ih ng
garbed	g aa r b d
garden	g aa r d ah n
gardens	g aa r d ah n z
gasped	g ae s p t
gate	g ey t
gates	g ey t s
gateway	g ey t w ey
gather	g ae dh er
gathered	g ae dh er d
gauged	g ey jh d
gave	g ey v
gay	g ey
gaze	g ey z
gazed	g ey z d
gazing	g ey z ih ng
geared	g ih r d
gearing	g ih r ih ng
gem	jh eh m
gems	jh eh m z
general	jh eh n er ah l
generated	jh eh n er ey t ah d
generations	jh eh n er ey sh ah n z
generosity	jh eh n er aa s ah t iy
genesis	jh eh n ah s ah s
gentle	jh eh n t ah l
gentleman	jh eh n t ah l m ah n
gentlemen	jh eh n t ah l m ih n
gently	jh eh n t l iy
genuine	jh eh n y uw ah n
gesture	jh eh s ch er
gestures	jh eh s ch er z
get	g eh t
getting	g eh t ih ng
ghastly	g ae s t l iy
ghost	g ow s t
ghostly	g ow s t l iy
ghoulish	g uw l ih sh
giant	jh ay ah n t
giants	jh ay ah n t s
gilded	g ih l d ih d
gingerly	jh ih n jh er l iy
girl	g er l
girls	g er l z
give	g ih v
given	g ih v ah n
gives	g ih v z
giving	g ih v ih ng
glad	g l ae d
gladly	g l ae d l iy
glance	g l ae n s
glanced	g l ae n s t
glancing	g l ae n s ih ng
glared	g l eh r d
glaring	g l eh r ih ng
glass	g l ae s
gleam	g l iy m
gleaming	g l iy m ih ng
glean	g l iy n
gleaned	g l iy n d
glide	g l ay d
glided	g l ay d ih d
glimmering	g l ih m er ih ng
glimpse	g l ih m p s
glistening	g l ih s ah n ih ng
gloating	g l ow t ih ng
glorified	g l ao r ah f ay d
glorious	g l ao r iy ah s
gloriously	g l ao r iy ah s l iy
glory	g l ao r iy
glossy	g l ao s iy
glove	g l ah v
glow	g l ow
glowering	g l aw er ih ng
glowing	g l ow ih ng
glued	g l uw d
go	g ow
goal	g ow l
god	g aa d
goddess	g aa d ah s
goddesses	g aa d ah s ih z
gods	g aa d z
goes	g ow z
going	g ow ih ng
gold	g ow l d
golden	g ow l d ah n
gone	g ao n
good	g uh d
goodly	g uh d l iy
gorgeous	g ao r jh ah s
gorilla	g er ih l ah
got	g aa t
gotten	g aa t ah n
governing	g ah v er n ih ng
government	g ah v er n m ah n t
grace	g r ey s
graceful	g r ey s f ah l
gracefully	g r ey s f ah l iy
gracious	g r ey sh ah s
grade	g r ey d
graded	g r ey d ah d
gradual	g r ae jh uw ah l
gradually	g r ae jh uw ah l iy
grained	g r ey n d
granddaughter	g r ae n d ao t er
grandeur	g r ae n d uw r
grandfather	g r ae n d f aa dh er
grant	g r ae n t
granted	g r ae n t ah d
grappled	g r ae p ah l d
grappling	g r ae p l ih ng
grasp	g r ae s p
grasped	g r ae s p t
grasping	g r ae s p ih ng
grass	g r ae s
grasslike	g r ae s l ay k
grated	g r ey t ih d
gratified	g r ae t ah f ay d
grating	g r ey t ih ng
gratitude	g r ae t ah t uw d
grave	g r ey v
graven	g r ey v ah n
graver	g r ey v er
gravity	g r ae v ah t iy
grazed	g r ey z d
grazing	g r ey z ih ng
great	g r ey t
greater	g r ey t er
greatest	g r ey t ah s t
greatly	g r ey t l iy
green	g r iy n
greens	g r iy n z
greet	g r iy t
greeted	g r iy t ah d
greeting	g r iy t ih ng
greetings	g r iy t ih ng z
greets	g r iy t s
grew	g r uw
grey	g r ey
grief	g r iy f
grieve	g r iy v
grieved	g r iy v d
grim	g r ih m
grimace	g r ih m ah s
grimly	g r ih m l iy
grin	g r ih n
grip	g r ih p
gripped	g r ih p t
grips	g r ih p s
grizzly	g r ih z l iy
groan	g r ow n
groin	g r oy n
groped	g r ow p t
groping	g r ow p ih ng
grotesque	g r ow t eh s k
ground	g r aw n d
grounds	g r aw n d z
group	g r uw p
grove	g r ow v
grovel	g r aa v ah l
grow	g r ow
growing	g r ow ih ng
growled	g r aw l d
growling	g r ow l ih ng
growls	g r aw l z
grown	g r ow n
grows	g r ow z
growth	g r ow th
gruel	g r uw ih l
gruesome	g r uw s ah m
grumbled	g r ah m b ah l d
grunted	g r ah n t ih d
grunting	g r ah n t ih ng
guarantee	g eh r ah n t iy
guard	g aa r d
guarded	g aa r d ah d
guardian	g aa r d iy ah n
guarding	g aa r d ih ng
guards	g aa r d z
guardsman	g aa r d z m ae n
guardsmen	g aa r d z m ih n
guess	g eh s
guessed	g eh s t
guide	g ay d
guided	g ay d ah d
guiding	g ay d ih ng
guilty	g ih l t iy
gulf	g ah l f
gullies	g ah l iy z
gun	g ah n
guns	g ah n z
gust	g ah s t
ha	hh aa
hacking	hh ae k ih ng
had	hh ae d
hades	hh ey d iy z
hail	hh ey l
hair	hh eh r
haired	hh eh r d
hairless	hh eh r l ah s
hairs	hh eh r z
half	hh ae f
halfway	hh ae f w ey
hall	hh ao l
halls	hh ao l z
hallucination	hh ah l uw s ah n ey sh ah n
hallway	hh ao l w ey
halo	hh ey l ow
halt	hh ao l t
halted	hh ao l t ah d
halts	hh ao l t s
hammer	hh ae m er
hand	hh ae n d
handed	hh ae n d ah d
handful	hh ae n d f uh l
handicapped	hh ae n d iy k ae p t
handing	hh ae n d ih ng
handle	hh ae n d ah l
handled	hh ae n d ah l d
hands	hh ae n d z
handsome	hh ae n s ah m
handsomely	hh ae n s ah m l iy
hang	hh ae ng
hangars	hh ae ng er z
hanging	hh ae ng ih ng
hangings	hh ae ng g ih ng z
hapless	hh ae p l ah s
happened	hh ae p ah n d
happiness	hh ae p iy n ah s
happy	hh ae p iy
harassed	hh er ae s t
harbour	hh aa r b er
hard	hh aa r d
hardships	hh aa r d sh ih p s
harm	hh aa r m
harmful	hh aa r m f ah l
harmless	hh aa r m l ah s
harmlessly	hh aa r m l ah s l iy
harness	hh aa r n ah s
harnessed	hh aa r n ah s t
harnesses	hh aa r n ah s ah z
harvest	hh aa r v ah s t
harvests	hh aa r v ah s t s
has	hh ae z
hast	hh ae s t
haste	hh ey s t
hasten	hh ey s ah n
hastened	hh ey s ah n d
hastening	hh ey s ah n ih ng
hastily	hh ey s t ah l iy
hasty	hh ey s t iy
hatch	hh ae ch
hate	hh ey t
hated	hh ey t ah d
hateful	hh ey t f ah l
hath	hh ae th
hatred	hh ey t r ah d
haughty	hh ao t iy
haul	hh ao l
haunted	hh ao n t ah d
haunts	hh ao n t s
have	hh ae v
haven	hh ey v ah n
having	hh ae v ih ng
havoc	hh ae v ah k
hawk	hh ao k
haze	hh ey z
he	hh iy
head	hh eh d
headed	hh eh d ah d
headless	hh eh d l ah s
headlong	hh eh d l ao ng
heads	hh eh d z
headway	hh eh d w ey
healing	hh iy l ih ng
heap	hh iy p
heaped	hh iy p t
heaps	hh iy p s
hear	hh iy r
heard	hh er d
hearing	hh iy r ih ng
hears	hh iy r z
heart	hh aa r t
hearted	hh aa r t ah d
heartless	hh aa r t l ah s
hearts	hh aa r t s
heat	hh iy t
heaven	hh eh v ah n
heavens	hh eh v ah n z
heavily	hh eh v ah l iy
heavy	hh eh v iy
heel	hh iy l
heels	hh iy l z
height	hh ay t
held	hh eh l d
helium	hh iy l iy ah m
hell	hh eh l
hellish	hh eh l ih sh
helm	hh eh l m
help	hh eh l p
helpless	hh eh l p l ah s
hemisphere	hh eh m ih s f ih r
hemmed	hh eh m d
hence	hh eh n s
her	hh er
herald	hh eh r ah l d
herd	hh er d
herded	hh er d ih d
herds	hh er d z
here	hh iy r
hereafter	hh ih r ae f t er
hereditary	hh er eh d ah t eh r iy
heresy	hh eh r ah s iy
heretics	hh eh r eh t ih k s
hero	hh ih r ow
hers	hh er z
herself	hh er s eh l f
hesitate	hh eh z ah t ey t
hesitated	hh eh z ih t ey t ih d
hesitates	hh eh z ah t ey t s
hesitating	hh eh z ah t ey t ih ng
hesitation	hh eh z ah t ey sh ah n
heterogeneous	hh eh t er ah jh iy n y ah s
hew	hh y uw
hewing	hh y uw ih ng
hewn	hh y uw n
hid	hh ih d
hidden	hh ih d ah n
hide	hh ay d
hideous	hh ih d iy ah s
hiding	hh ay d ih ng
high	hh ay
higher	hh ay er
highest	hh ay ah s t
highly	hh ay l iy
hill	hh ih l
hills	hh ih l z
hillside	hh ih l s ay d
hilt	hh ih l t
him	hh ih m
himself	hh ih m s eh l f
hind	hh ay n d
hinge	hh ih n jh
hinged	hh ih n jh d
hips	hh ih p s
his	hh ih z
hissed	hh ih s t
hissing	hh ih s ih ng
historic	hh ih s t ao r ih k
history	hh ih s t er iy
hit	hh ih t
hither	hh ih dh er
hitting	hh ih t ih ng
ho	hh ow
hoard	hh ao r d
hoarse	hh ao r s
hobbled	hh aa b ah l d
hold	hh ow l d
holder	hh ow l d er
holding	hh ow l d ih ng
holds	hh ow l d z
hole	hh ow l
holes	hh ow l z
holier	hh ow l iy er
hollow	hh aa l ow
holy	hh ow l iy
home	hh ow m
homes	hh ow m z
honour	aa n er
honoured	aa n er d
hooks	hh uh k s
hope	hh ow p
hoped	hh ow p t
hopefulness	hh ow p f ah l n ih s
hopeless	hh ow p l ah s
hopelessly	hh ow p l ah s l iy
hopelessness	hh ow p l ah s n ah s
hopes	hh ow p s
hoping	hh ow p ih ng
hopping	hh aa p ih ng
horde	hh ao r d
hordes	hh ao r d z
horizon	hh er ay z ah n
horizontal	hh ao r ah z aa n t ah l
horizontally	hh ao r ih z aa n t ah l iy
horrible	hh ao r ah b ah l
horribly	hh ao r ah b l iy
horrid	hh ao r ah d
horrified	hh ao r ah f ay d
horrifying	hh ao r ah f ay ih ng
horror	hh ao r er
horrors	hh ao r er z
hospitality	hh aa s p ah t ae l ah t iy
hostage	hh aa s t ih jh
hostess	hh ow s t ah s
hostile	hh aa s t ah l
hostilities	hh aa s t ih l ah t iy z
hot	hh aa t
hotel	hh ow t eh l
hotly	hh aa t l iy
hottest	hh aa t ah s t
hound	hh aw n d
hour	aw er
hours	aw er z
house	hh aw s
housed	hh aw z d
household	hh aw s hh ow l d
houses	hh aw s ah z
housings	hh aw z ih ng z
hovered	hh ah v er d
how	hh aw
however	hh aw eh v er
howled	hh aw l d
howling	hh aw l ih ng
howls	hh aw l z
huddled	hh ah d ah l d
hudson	hh ah d s ah n
hue	hh y uw
hues	hh y uw z
huge	hh y uw jh
hugging	hh ah g ih ng
hulks	hh ah l k s
hum	hh ah m
human	hh y uw m ah n
humanitarian	hh y uw m ae n ah t eh r iy ah n
humanity	hh y uw m ae n ih t iy
humans	hh y uw m ah n z
humiliate	hh y uw m ih l iy ey t
humiliated	hh y uw m ih l iy ey t ih d
humiliating	hh y uw m ih l iy ey t ih ng
humiliation	hh y uw m ih l iy ey sh ah n
humour	hh y uw m er
hundred	hh ah n d r ah d
hundreds	hh ah n d r ah d z
hung	hh ah ng
hunger	hh ah ng g er
hungrily	hh ah ng g r ah l iy
hungry	hh ah ng g r iy
hunting	hh ah n t ih ng
hurl	hh er l
hurled	hh er l d
hurling	hh er l ih ng
hurried	hh er iy d
hurriedly	hh er iy d l iy
hurrying	hh er iy ih ng
hurt	hh er t
hurtling	hh er t l ih ng
husband	hh ah z b ah n d
hustled	hh ah s ah l d
hustling	hh ah s ah l ih ng
hybrids	hh ay b r ah d z
hypothesis	hh ay p aa th ah s ah s
hysterical	hh ih s t eh r ih k ah l
i	ay
ice	ay s
icy	ay s iy
idea	ay d iy ah
ideas	ay d iy ah z
identical	ay d eh n t ih k ah l
identity	ay d eh n t ah t iy
idle	ay d ah l
idleness	ay d ah l n ah s
if	ih f
ignoble	ih g n ow b ah l
ignominious	ih g n ah m ih n iy ah s
ignominy	ih g n ow m ih n iy
ignorance	ih g n er ah n s
ignorant	ih g n er ah n t
ill	ih l
illuminated	ih l uw m ah n ey t ah d
illuminates	ih l uw m ah n ey t s
illuminating	ih l uw m ah n ey t ih ng
illuminator	ih l uw m ah n ey t er
illusive	ih l uw s ih v
illustrations	ih l ah s t r ey sh ah n z
image	ih m ah jh
imagination	ih m ae jh ah n ey sh ah n
imagine	ih m ae jh ah n
imagined	ih m ae jh ah n d
immeasurable	ih m eh zh er ae b ah l
immediate	ih m iy d iy ah t
immediately	ih m iy d iy ah t l iy
immemorial	ih m ah m ao r iy ah l
immense	ih m eh n s
immensely	ih m eh n s l iy
immortal	ih m ao r t ah l
immortality	ih m ao r t ae l ih t iy
impact	ih m p ae k t
impart	ih m p aa r t
impartial	ih m p aa r sh ah l
impartially	ih m p aa r sh ah l iy
impatiently	ih m p ey sh ah n t l iy
impeding	ih m p iy d ih ng
impenetrable	ih m p eh n ah t r ah b ah l
imperative	ih m p eh r ah t ih v
imperceptible	ih m p er s eh p t ih b ah l
impetus	ih m p ah t ah s
implement	ih m p l ah m ah n t
implements	ih m p l ah m ah n t s
implored	ih m p l ao r d
imploring	ih m p l ao r ih ng
import	ih m p ao r t
importance	ih m p ao r t ah n s
important	ih m p ao r t ah n t
imposed	ih m p ow z d
imposing	ih m p ow z ih ng
impossibility	ih m p ao s ih b ih l ih t iy
impossible	ih m p aa s ah b ah l
impotent	ih m p ah t ah n t
impregnable	ih m p r eh g n ah b ah l
impress	ih m p r eh s
impressed	ih m p r eh s t
impression	ih m p r eh sh ah n
imprinted	ih m p r ih n t ih d
imprisoned	ih m p r ih z ah n d
imprisonment	ih m p r ih z ah n m ah n t
imprisons	ih m p r ih z ah n z
improbable	ih m p r aa b ah b ah l
improvement	ih m p r uw v m ah n t
impulse	ih m p ah l s
in	ih n
incarceration	ih n k aa r s er ey sh ah n
incarnate	ih n k aa r n ah t
inch	ih n ch
inches	ih n ch ah z
incident	ih n s ah d ah n t
incidents	ih n s ah d ah n t s
incline	ih n k l ay n
inclined	ih n k l ay n d
inclines	ih n k l ay n z
included	ih n k l uw d ah d
including	ih n k l uw d ih ng
incoherent	ih n k ow hh ih r ah n t
incomparable	ih n k aa m p er ah b ah l
increase	ih n k r iy s
increased	ih n k r iy s t
increasing	ih n k r iy s ih ng
incredibly	ih n k r eh d ah b l iy
incredulity	ih n k r ah d uw l ih t iy
incredulous	ih n k r eh jh ah l ah s
incubator	ih ng k y ah b ey t er
indebted	ih n d eh t ih d
indeed	ih n d iy d
indefinable	ih n d ih f ay n ah b ah l
indefinitely	ih n d eh f ah n ah t l iy
indelibly	ih n d eh l ah b l iy
independent	ih n d ih p eh n d ah n t
indescribable	ih n d ih s k r ay b ah b ah l
index	ih n d eh k s
indicate	ih n d ah k ey t
indicated	ih n d ah k ey t ah d
indicating	ih n d ah k ey t ih ng
indication	ih n d ah k ey sh ah n
indignities	ih n d ih g n ah t iy z
indignity	ih n d ih g n ah t iy
individual	ih n d ah v ih jh ah w ah l
individuals	ih n d ah v ih jh ah w ah l z
indomitable	ih n d aa m ah t ah b ah l
inert	ih n er t
inevitable	ih n eh v ah t ah b ah l
inextricable	ih n eh k s t r ih k ah b ah l
infatuation	ih n f ae ch uw ey sh ah n
inferior	ih n f ih r iy er
infernal	ih n f er n ah l
inferno	ih n f er n ow
infinite	ih n f ah n ah t
infinitely	ih n f ah n ah t l iy
inflamed	ih n f l ey m d
influence	ih n f l uw ah n s
inform	ih n f ao r m
information	ih n f ao r m ey sh ah n
infuriated	ih n f y uh r iy ey t ih d
inglorious	ih n g l ao r iy ah s
inhabit	ih n hh ae b ah t
inhabitants	ih n hh ae b ih t ah n t s
inhabited	ih n hh ae b ah t ah d
inherent	ih n hh eh r ah n t
inherit	ih n hh eh r ah t
inherited	ih n hh eh r ah t ih d
initiative	ih n ih sh ah t ih v
injure	ih n jh er
injustice	ih n jh ah s t ih s
inky	ih ng k iy
inlaid	ih n l ey d
inmates	ih n m ey t s
inner	ih n er
innocence	ih n ah s ah n s
innocent	ih n ah s ah n t
inopportune	ih n aa p er t uw n
inquiring	ih n k w ay er ih ng
insanity	ih n s ae n ah t iy
inserted	ih n s er t ah d
inside	ih n s ay d
insignia	ih n s ih g n iy ah
insignificance	ih n s ih g n y ih f ih k ah n s
insist	ih n s ih s t
insisted	ih n s ih s t ah d
insistence	ih n s ih s t ah n s
inspect	ih n s p eh k t
inspected	ih n s p eh k t ih d
inspection	ih n s p eh k sh ah n
inspired	ih n s p ay er d
inspiring	ih n s p ay r ih ng
instance	ih n s t ah n s
instant	ih n s t ah n t
instantly	ih n s t ah n t l iy
instead	ih n s t eh d
instilled	ih n s t ih l d
instinct	ih n s t ih ng k t
instinctively	ih n s t ih ng k t ih v l iy
instincts	ih n s t ih ng k t s
instructed	ih n s t r ah k t ah d
instructions	ih n s t r ah k sh ah n z
instrument	ih n s t r ah m ah n t
instrumental	ih n s t r ah m eh n t ah l
instruments	ih n s t r ah m ah n t s
insult	ih n s ah l t
insults	ih n s ah l t s
intact	ih n t ae k t
intelligent	ih n t eh l ah jh ah n t
intend	ih n t eh n d
intended	ih n t eh n d ih d
intense	ih n t eh n s
intensely	ih n t eh n s l iy
intent	ih n t eh n t
intention	ih n t eh n ch ah n
intentions	ih n t eh n ch ah n z
intently	ih n t eh n t l iy
intercept	ih n t er s eh p t
intercepted	ih n t er s eh p t ah d
interest	ih n t ah r eh s t
interested	ih n t ah r eh s t ih d
interesting	ih n t ah r eh s t ih ng
interfere	ih n t er f ih r
interfered	ih n t er f ih r d
interior	ih n t ih r iy er
intermediary	ih n er m iy d iy eh r iy
interminable	ih n t er m ah n ah b ah l
international	ih n t er n ae sh ah n aa l
interplanetary	ih n t er p l ae n ah t eh r iy
interpreted	ih n t er p r ah t ah d
interrupt	ih n t er ah p t
interrupted	ih n t er ah p t ih d
interruption	ih n t er ah p sh ah n
intersecting	ih n t er s eh k t ih ng
intersection	ih n t er s eh k sh ah n
intersections	ih n t er s eh k sh ah n z
interval	ih n t er v ah l
intervals	ih n t er v ah l z
intervened	ih n t er v iy n d
intervening	ih n t er v iy n ih ng
interview	ih n t er v y uw
into	ih n t uw
intricate	ih n t r ah k ah t
intrigues	ih n t r iy g z
introduction	ih n t r ah d ah k sh ah n
intruded	ih n t r uw d ah d
intuition	ih n t uw ih sh ah n
intuitively	ih n t uw ih t ih v l iy
invent	ih n v eh n t
inventing	ih n v eh n t ih ng
inventory	ih n v ah n t ao r iy
invents	ih n v eh n t s
inverse	ih n v er s
investigate	ih n v eh s t ah g ey t
investigating	ih n v eh s t ah g ey t ih ng
investigation	ih n v eh s t ah g ey sh ah n
invisible	ih n v ih z ah b ah l
invite	ih n v ay t
inviting	ih n v ay t ih ng
involuntarily	ih n v ow l ah n t er ih l iy
involve	ih n v aa l v
involved	ih n v aa l v d
iridescent	ih r ah d eh s ah n t
iris	ay r ah s
iron	ay er n
ironical	ay r aa n ih k ah l
irons	ay er n z
irony	ay r ah n iy
irresistible	ih r ih z ih s t ah b ah l
irrigation	ih r ah g ey sh ah n
is	ih z
island	ay l ah n d
islands	ay l ah n d z
isle	ay l
islets	ay l ih t s
issue	ih sh uw
issued	ih sh uw d
issues	ih sh uw z
issuing	ih sh uw ih ng
it	ih t
its	ih t s
itself	ih t s eh l f
ivory	ay v er iy
jailer	jh ey l er
jammed	jh ae m d
jaw	jh ao
jaws	jh ao z
jed	jh eh d
jeering	jh iy r ih ng
jeopardize	jh eh p er d ay z
jeopardized	jh eh p er d ay z d
jests	jh eh s t s
jet	jh eh t
jewel	jh uw ah l
jewels	jh uw ah l z
job	jh aa b
john	jh aa n
join	jh oy n
joined	jh oy n d
jolt	jh ow l t
jolted	jh ow l t ih d
journey	jh er n iy
jowls	jh aw l z
joy	jh oy
judge	jh ah jh
judged	jh ah jh d
judges	jh ah jh ih z
judgment	jh ah jh m ah n t
judgments	jh ah jh m ah n t s
juice	jh uw s
juleps	jh uw l ah p s
jump	jh ah m p
jumped	jh ah m p t
jumper	jh ah m p er
juncture	jh ah ng k ch er
jury	jh uh r iy
just	jh ah s t
justice	jh ah s t ah s
kan	k ae n
kangaroo	k ae ng g er uw
keel	k iy l
keen	k iy n
keener	k iy n er
keenest	k iy n ah s t
keep	k iy p
keeper	k iy p er
keeping	k iy p ih ng
kept	k eh p t
key	k iy
keys	k iy z
kick	k ih k
kicked	k ih k t
kill	k ih l
killed	k ih l d
killing	k ih l ih ng
kind	k ay n d
kindly	k ay n d l iy
kindred	k ih n d r ih d
kiss	k ih s
kissed	k ih s t
kisses	k ih s ah z
kissing	k ih s ih ng
kitchens	k ih ch ah n z
knee	n iy
kneel	n iy l
kneeling	n iy l ih ng
knees	n iy z
knew	n uw
knob	n aa b
knocking	n aa k ih ng
knot	n aa t
know	n ow
knowing	n ow ih ng
knowledge	n aa l ah jh
known	n ow n
knows	n ow z
labour	l ey b er
labyrinthine	l ae b er ih n th iy n
ladder	l ae d er
laden	l ey d ah n
ladies	l ey d iy z
lady	l ey d iy
lagged	l ae g d
lagging	l ae g ih ng
laid	l ey d
lain	l ey n
lake	l ey k
lakes	l ey k s
lamp	l ae m p
lance	l ae n s
land	l ae n d
landed	l ae n d ah d
landing	l ae n d ih ng
lands	l ae n d z
landscape	l ae n d s k ey p
lane	l ey n
language	l ae ng g w ah jh
languages	l ae ng g w ah jh ah z
languished	l ae ng g w ih sh t
lapping	l ae p ih ng
laps	l ae p s
larder	l aa r d er
large	l aa r jh
largely	l aa r jh l iy
larger	l aa r jh er
lashed	l ae sh t
lashing	l ae sh ih ng
last	l ae s t
latch	l ae ch
late	l ey t
later	l ey t er
latter	l ae t er
lauded	l ao d ih d
laugh	l ae f
laughed	l ae f t
laughing	l ae f ih ng
laughs	l ae f s
laughter	l ae f t er
launched	l ao n ch t
launching	l ao n ch ih ng
law	l ao
lawn	l ao n
lawns	l ao n z
laws	l ao z
lax	l ae k s
lay	l ey
layers	l ey er z
layman	l ey m ah n
lazily	l ae z ah l iy
lead	l eh d
leaden	l eh d ah n
leader	l iy d er
leading	l iy d ih ng
leads	l iy d z
leaf	l iy f
leaked	l iy k t
leaned	l iy n d
leaning	l iy n ih ng
leap	l iy p
leaped	l eh p t
leaping	l iy p ih ng
leaps	l iy p s
learn	l er n
learned	l er n d
least	l iy s t
leather	l eh dh er
leave	l iy v
leaving	l iy v ih ng
led	l eh d
ledge	l eh jh
left	l eh f t
leg	l eh g
legend	l eh jh ah n d
legends	l eh jh ah n d z
legged	l eh g ah d
legible	l eh jh ah b ah l
legion	l iy jh ah n
legs	l eh g z
leisurely	l iy z er l iy
lends	l eh n d z
length	l eh ng k th
lengths	l eh ng k th s
lent	l eh n t
less	l eh s
lessened	l eh s ah n d
lessening	l eh s ah n ih ng
lesser	l eh s er
lesson	l eh s ah n
let	l eh t
lets	l eh t s
letting	l eh t ih ng
level	l eh v ah l
levelled	l eh v ah l d
levels	l eh v ah l z
lever	l eh v er
levers	l eh v er z
liar	l ay er
liberated	l ih b er ey t ih d
liberty	l ih b er t iy
licked	l ih k t
lids	l ih d z
lie	l ay
lies	l ay z
lieu	l uw
life	l ay f
lifeblood	l ay f b l ah d
lifeless	l ay f l ah s
lift	l ih f t
lifted	l ih f t ah d
light	l ay t
lighted	l ay t ah d
lightened	l ay t ah n d
lightening	l ay t ah n ih ng
lighter	l ay t er
lighters	l ay t er z
lightest	l ay t ah s t
lighting	l ay t ih ng
lightly	l ay t l iy
lightning	l ay t n ih ng
lights	l ay t s
like	l ay k
likelihood	l ay k l iy hh uh d
likely	l ay k l iy
likeness	l ay k n ah s
likewise	l ay k w ay z
limb	l ih m
limbed	l ih m d
limbs	l ih m z
limit	l ih m ah t
limited	l ih m ah t ah d
line	l ay n
lineage	l ih n iy ah jh
lined	l ay n d
lines	l ay n z
link	l ih ng k
linked	l ih ng k t
lion	l ay ah n
lip	l ih p
lips	l ih p s
liquid	l ih k w ah d
list	l ih s t
listen	l ih s ah n
listened	l ih s ah n d
listening	l ih s ah n ih ng
lit	l ih t
literally	l ih t er ah l iy
lithe	l ay dh
little	l ih t ah l
live	l ay v
lived	l ih v d
lives	l ih v z
livid	l ih v ih d
living	l ih v ih ng
loath	l ow th
loathe	l ow dh
loathing	l ow th ih ng
locate	l ow k ey t
located	l ow k ey t ah d
location	l ow k ey sh ah n
lock	l aa k
locked	l aa k t
locking	l aa k ih ng
locks	l aa k s
locomotion	l ow k ah m ow sh ah n
lodged	l aa jh d
lofty	l ao f t iy
loneliness	l ow n l iy n ah s
lonesome	l ow n s ah m
long	l ao ng
longed	l ao ng d
longer	l ao ng g er
longest	l ao ng g ah s t
look	l uh k
looked	l uh k t
looking	l uh k ih ng
loomed	l uw m d
loose	l uw s
loosed	l uw s t
loot	l uw t
looting	l uw t ih ng
lord	l ao r d
lose	l uw z
losing	l uw z ih ng
loss	l ao s
lost	l ao s t
lot	l aa t
lotions	l ow sh ah n z
loud	l aw d
louder	l aw d er
love	l ah v
loved	l ah v d
loveless	l ah v l ah s
lovely	l ah v l iy
loving	l ah v ih ng
low	l ow
lower	l ow er
lowered	l ow er d
lowest	l ow ah s t
loyal	l oy ah l
loyalty	l oy ah l t iy
luckless	l ah k l ah s
lunged	l ah n jh d
lungs	l ah ng z
lurched	l er ch t
lure	l uh r
lured	l uh r d
lurid	l uh r ah d
lurked	l er k t
lurking	l er k ih ng
lust	l ah s t
lusting	l ah s t ih ng
luxuriant	l ah g zh er iy ah n t
luxurious	l ah g zh er iy ah s
luxury	l ah g zh er iy
lying	l ay ih ng
m	eh m
machinations	m ae k ah n ey sh ah n z
machinery	m ah sh iy n er iy
mad	m ae d
maddening	m ae d ah n ih ng
made	m ey d
madly	m ae d l iy
madman	m ae d m ae n
maelstrom	m ey l s t r ah m
maggots	m ae g ah t s
magic	m ae jh ih k
magically	m ae jh ih k ah l iy
magistrate	m ae jh ah s t r ey t
magnanimous	m ae g n ae n ah m ah s
magnetism	m ae g n ah t ih z ah m
magnets	m ae g n ah t s
magnificent	m ae g n ih f ah s ah n t
magnifies	m ae g n ah f ay z
maid	m ey d
maiden	m ey d ah n
maidens	m ey d ah n z
maids	m ey d z
maimed	m ey m d
main	m ey n
maintain	m ey n t ey n
maintained	m ey n t ey n d
maintains	m ey n t ey n z
majestic	m ah jh eh s t ih k
majestically	m ah jh eh s t ih k ah l iy
majesty	m ae jh ah s t iy
majority	m ah jh ao r ah t iy
make	m ey k
makes	m ey k s
making	m ey k ih ng
malefactor	m ae l ah f ae k t er
males	m ey l z
malicious	m ah l ih sh ah s
maliciously	m ah l ih sh ih s l iy
malign	m ah l ay n
malignant	m ah l ih g n ah n t
man	m ae n
managed	m ae n ah jh d
mane	m ey n
maned	m ey n d
manhood	m ae n hh uh d
maniac	m ey n iy ae k
manifestation	m ae n ah f eh s t ey sh ah n
manly	m ae n l iy
manned	m ae n d
manner	m ae n er
manning	m ae n ih ng
manufactured	m ae n y ah f ae k ch er d
manuscript	m ae n y ah s k r ih p t
many	m eh n iy
map	m ae p
mapped	m ae p t
marauder	m er ao d er
marauders	m er ao d er z
marble	m aa r b ah l
march	m aa r ch
marched	m aa r ch t
marked	m aa r k t
marks	m aa r k s
marksmanship	m aa r k s m ah n sh ih p
marriage	m eh r ih jh
married	m eh r iy d
marrow	m eh r ow
mars	m aa r z
martian	m aa r sh ah n
martians	m aa r sh ah n z
martyrdom	m aa r t er d ah m
martyrs	m aa r t er z
marvellous	m aa r v ah l ah s
masculine	m ae s k y ah l ah n
mass	m ae s
massacring	m ae s ah k er ih ng
massed	m ae s t
massive	m ae s ih v
master	m ae s t er
mastered	m ae s t er d
mastering	m ae s t er ih ng
masters	m ae s t er z
match	m ae ch
mate	m ey t
material	m ah t ih r iy ah l
materialize	m ah t ih r iy ah l ay z
materially	m ah t ih r iy ah l iy
materials	m ah t ih r iy ah l z
matter	m ae t er
matters	m ae t er z
mature	m ah ch uh r
maudlin	m ao d l ih n
mausoleum	m ao s ah l iy ah m
may	m ey
maybe	m ey b iy
maze	m ey z
mazes	m ey z ih z
me	m iy
meadow	m eh d ow
mean	m iy n
meanest	m iy n ah s t
meaning	m iy n ih ng
means	m iy n z
meant	m eh n t
meantime	m iy n t ay m
measure	m eh zh er
measurements	m eh zh er m ah n t s
mechanism	m eh k ah n ih z ah m
medicinal	m ah d ih s ah n ah l
meditate	m eh d ah t ey t
meditating	m eh d ah t ey t ih ng
medium	m iy d iy ah m
meet	m iy t
meeting	m iy t ih ng
melee	m ey l ey
melting	m eh l t ih ng
member	m eh m b er
members	m eh m b er z
memorable	m eh m er ah b ah l
memorial	m ah m ao r iy ah l
memories	m eh m er iy z
memory	m eh m er iy
men	m eh n
menaced	m eh n ah s t
menacing	m eh n ah s ih ng
mental	m eh n t ah l
mention	m eh n sh ah n
menu	m eh n y uw
merchantmen	m er ch ah n t m ih n
merciful	m er s ih f ah l
mercy	m er s iy
mere	m ih r
merely	m ih r l iy
merited	m eh r ih t ih d
merits	m eh r ah t s
merry	m eh r iy
message	m eh s ah jh
messages	m eh s ah jh ah z
messenger	m eh s ah n jh er
messengers	m eh s ah n jh er z
met	m eh t
metal	m eh t ah l
metals	m eh t ah l z
mete	m iy t
meted	m iy t ih d
meteoric	m iy t iy ao r ih k
meteors	m iy t iy er z
method	m eh th ah d
methods	m eh th ah d z
methought	m eh th ao t
metropolis	m ah t r aa p ah l ah s
mid	m ih d
middle	m ih d ah l
midnight	m ih d n ay t
midst	m ih d s t
midway	m ih d w ey
might	m ay t
mightiest	m ay t iy ah s t
mighty	m ay t iy
mild	m ay l d
mile	m ay l
miles	m ay l z
milk	m ih l k
million	m ih l y ah n
millions	m ih l y ah n z
minaret	m ih n er eh t
minarets	m ih n er eh t s
mind	m ay n d
minds	m ay n d z
mine	m ay n
mingled	m ih ng g ah l d
mingling	m ih ng g ah l ih ng
minimized	m ih n ah m ay z d
minister	m ih n ah s t er
minor	m ay n er
minute	m ih n ah t
minutes	m ih n ah t s
miracle	m ih r ah k ah l
miraculous	m er ae k y ah l ah s
miraculously	m er ae k y ah l ah s l iy
mirror	m ih r er
mirth	m er th
misfortune	m ih s f ao r ch ah n
misfortunes	m ih s f ao r ch ah n z
misgivings	m ih s g ih v ih ng z
mishap	m ih s hh ae p
missed	m ih s t
mission	m ih sh ah n
mist	m ih s t
mistaken	m ih s t ey k ah n
mistress	m ih s t r ah s
misunderstood	m ih s ah n d er s t uh d
mixture	m ih k s ch er
moans	m ow n z
mob	m aa b
mobs	m aa b z
mock	m aa k
mockery	m aa k er iy
mocking	m aa k ih ng
moist	m oy s t
molested	m ah l eh s t ih d
moment	m ow m ah n t
momentarily	m ow m ah n t eh r ah l iy
momentary	m ow m ah n t eh r iy
moments	m ow m ah n t s
momentum	m ow m eh n t ah m
monster	m aa n s t er
monsters	m aa n s t er z
monstrosity	m aa n s t r aa s ah t iy
monstrous	m aa n s t r ah s
month	m ah n th
monthly	m ah n th l iy
months	m ah n th s
moon	m uw n
moonlight	m uw n l ay t
moons	m uw n z
moored	m uh r d
moorings	m uw r ih ng z
mope	m ow p
moral	m ao r ah l
more	m ao r
morning	m ao r n ih ng
morrow	m aa r ow
mortal	m ao r t ah l
mortals	m ao r t ah l z
moss	m ao s
most	m ow s t
mostly	m ow s t l iy
mother	m ah dh er
motherhood	m ah dh er hh uh d
motion	m ow sh ah n
motioned	m ow sh ah n d
motioning	m ow sh ah n ih ng
motionless	m ow sh ah n l ah s
motive	m ow t ih v
motives	m ow t ih v z
motley	m aa t l iy
mount	m aw n t
mountain	m aw n t ah n
mountains	m aw n t ah n z
mounted	m aw n t ah d
mounts	m aw n t s
mourn	m ao r n
mourned	m ao r n d
mournful	m ao r n f ah l
mourns	m ao r n z
mouth	m aw th
mouths	m aw dh z
move	m uw v
moved	m uw v d
movement	m uw v m ah n t
movements	m uw v m ah n t s
moves	m uw v z
moving	m uw v ih ng
mowed	m ow d
much	m ah ch
muffled	m ah f ah l d
multitude	m ah l t ah t uw d
multitudes	m ah l t ah t y uw d z
mumbled	m ah m b ah l d
murdered	m er d er d
murderer	m er d er er
murdering	m er d er ih ng
murmur	m er m er
murmured	m er m er d
muscle	m ah s ah l
muscled	m ah s ah l d
muscles	m ah s ah l z
muscular	m ah s k y ah l er
music	m y uw z ih k
must	m ah s t
mute	m y uw t
mutiny	m y uw t ah n iy
muttered	m ah t er d
my	m ay
myriad	m ih r iy ah d
myself	m ay s eh l f
mysteries	m ih s t er iy z
mysterious	m ih s t ih r iy ah s
mystery	m ih s t er iy
mystic	m ih s t ih k
mystified	m ih s t ah f ay d
mystify	m ih s t ah f ay
naked	n ey k ah d
name	n ey m
named	n ey m d
nameless	n ey m l ah s
names	n ey m z
narrate	n eh r ey t
narrated	n eh r ey t ih d
narration	n eh r ey sh ah n
narrative	n ae r ah t ih v
narrow	n eh r ow
narrowed	n eh r ow d
narrowing	n eh r ow ih ng
narrowly	n eh r ow l iy
narrowness	n eh r ow n ah s
nasty	n ae s t iy
nation	n ey sh ah n
natural	n ae ch er ah l
naturally	n ae ch er ah l iy
nature	n ey ch er
naught	n ao t
nausea	n ao z iy ah
naval	n ey v ah l
navies	n ey v iy z
navigate	n ae v ah g ey t
navigation	n ae v ah g ey sh ah n
navy	n ey v iy
ne	n iy
near	n ih r
nearby	n ih r b ay
neared	n ih r d
nearer	n ih r er
nearest	n ih r ah s t
nearly	n ih r l iy
necessary	n eh s ah s eh r iy
necessitated	n ah s eh s ah t ey t ah d
necessitating	n ah s eh s ih t ey t ih ng
necessity	n ah s eh s ah t iy
neck	n eh k
necks	n eh k s
need	n iy d
needed	n iy d ah d
needle	n iy d ah l
needs	n iy d z
negotiate	n ah g ow sh iy ey t
negotiations	n ah g ow sh iy ey sh ah n z
neighboring	n ey b er ih ng
neighbour	n ey b er
neighbours	n ey b er z
neither	n iy dh er
nephew	n eh f y uw
nerve	n er v
nerves	n er v z
nervous	n er v ah s
net	n eh t
network	n eh t w er k
neutral	n uw t r ah l
never	n eh v er
nevertheless	n eh v er dh ah l eh s
new	n uw
newest	n uw ah s t
newly	n uw l iy
news	n uw z
next	n eh k s t
nicely	n ay s l iy
night	n ay t
nightmare	n ay t m eh r
nights	n ay t s
nine	n ay n
ninety	n ay n t iy
nipped	n ih p t
no	n ow
noble	n ow b ah l
nobles	n ow b ah l z
noblest	n ow b l ih s t
nobly	n aa b l iy
nodded	n aa d ah d
nods	n aa d z
noise	n oy z
noises	n oy z ih z
nomadic	n ow m ae d ih k
non	n aa n
none	n ah n
nonplussed	n aa n p l ah s t
noon	n uw n
nor	n ao r
north	n ao r th
northerly	n ao r dh er l iy
northern	n ao r dh er n
nose	n ow z
noses	n ow z ih z
nostrils	n aa s t r ah l z
not	n aa t
notch	n aa ch
note	n ow t
noted	n ow t ah d
notes	n ow t s
nothing	n ah th ih ng
notice	n ow t ah s
noticeable	n ow t ah s ah b ah l
noticeably	n ow t ih s ah b l iy
noticed	n ow t ih s t
notified	n ow t ah f ay d
noting	n ow t ih ng
notwithstanding	n aa t w ih th s t ae n d ih ng
now	n aw
nowhere	n ow w eh r
number	n ah m b er
numbers	n ah m b er z
numbing	n ah m ih ng
numerically	n uw m eh r ih k l iy
numerous	n uw m er ah s
nuts	n ah t s
o	ow
oath	ow th
obey	ow b ey
obeyed	ow b ey d
object	aa b jh eh k t
objective	ah b jh eh k t ih v
objects	aa b jh eh k t s
obligation	aa b l ah g ey sh ah n
oblivion	ah b l ih v iy ah n
observations	aa b z er v ey sh ah n z
observed	ah b z er v d
obsolete	aa b s ah l iy t
obstacle	aa b s t ah k ah l
obstacles	aa b s t ah k ah l z
obstruction	ah b s t r ah k sh ah n
obtained	ah b t ey n d
occasion	ah k ey zh ah n
occasional	ao k ey zh ah n ah l
occasionally	ao k ey zh ah n ah l iy
occasions	ao k ey zh ah n z
occupancy	aa k y ah p ah n s iy
occupant	aa k y ah p ah n t
occupants	aa k y ah p ah n t s
occupation	aa k y ah p ey sh ah n
occupied	aa k y ah p ay d
occupy	aa k y ah p ay
occupying	aa k y ah p ay ih ng
occurred	ah k er d
occurrence	ah k er ah n s
occurrences	ah k er ah n s ih z
ocean	ow sh ah n
ochre	ow k er
odd	aa d
oddly	aa d l iy
odds	aa d z
odours	ow d er s
of	ah v
off	ao f
offended	ah f eh n d ah d
offer	ao f er
offered	ao f er d
offering	ao f er ih ng
offers	ao f er z
office	ao f ah s
officer	ao f ah s er
officers	ao f ah s er z
official	ah f ih sh ah l
offspring	ao f s p r ih ng
oft	ao f t
often	ao f t ah n
oftener	ao f t ah n er
oh	ow
oil	oy l
old	ow l d
oldest	ow l d ah s t
omnipotence	aa m n ih p ah t ah n s
omnipotent	aa m n ih p ah t ah n t
omniscient	aa m n ih sh ah n t
on	aa n
once	w ah n s
oncoming	ao n k ah m ih ng
one	w ah n
ones	w ah n z
only	ow n l iy
onslaught	ao n s l ao t
oozes	uw z ih z
open	ow p ah n
opened	ow p ah n d
opening	ow p ah n ih ng
openings	ow p ah n ih ng z
openly	ow p ah n l iy
opens	ow p ah n z
operated	aa p er ey t ah d
operating	aa p er ey t ih ng
operation	aa p er ey sh ah n
operator	aa p er ey t er
opinions	ah p ih n y ah n z
opponent	ah p ow n ah n t
opponents	ah p ow n ah n t s
opportunities	aa p er t uw n ah t iy z
opportunity	aa p er t uw n ah t iy
oppose	ah p ow z
opposing	ah p ow z ih ng
opposite	aa p ah z ih t
opposition	aa p ah z ih sh ah n
or	ao r
orb	ao r b
ordained	ao r d ey n d
ordeal	ao r d iy l
order	ao r d er
ordered	ao r d er d
orderly	ao r d er l iy
orders	ao r d er z
ordinary	ao r d ah n eh r iy
organism	ao r g ah n ih z ah m
organized	ao r g ah n ay z d
orgy	ao r jh iy
orifice	ao r ah f ah s
origin	ao r ah jh ah n
original	er ih jh ah n ah l
ornaments	ao r n ah m ah n t s
other	ah dh er
others	ah dh er z
otherwise	ah dh er w ay z
ounce	aw n s
our	aw er
ours	aw er z
ourselves	aw er s eh l v z
out	aw t
outclassed	aw t k l ae s t
outcome	aw t k ah m
outcry	aw t k r ay
outdistance	aw t d ih s t ah n s
outer	aw t er
outfitted	aw t f ih t ih d
outlaw	aw t l ao
outlined	aw t l ay n d
outlines	aw t l ay n z
outlook	aw t l uh k
outraged	aw t r ey jh d
outside	aw t s ay d
outskirts	aw t s k er t s
outstretched	aw t s t r eh ch t
outward	aw t w er d
outwitted	aw t w ih t ah d
oval	ow v ah l
over	ow v er
overboard	ow v er b ao r d
overcame	ow v er k ey m
overcome	ow v er k ah m
overflow	ow v er f l ow
overhanging	ow v er hh ae ng ih ng
overhauled	ow v er hh ao l d
overhauling	ow v er hh ao l ih ng
overhead	ow v er hh eh d
overheard	ow v er hh er d
overlapping	ow v er l ae p ih ng
overlooked	ow v er l uh k t
overlooking	ow v er l uh k ih ng
overly	ow v er l iy
overran	ow v er r ae n
overrunning	ow v er r ah n ih ng
oversupply	ow v er s ah p l ay
overtake	ow v er t ey k
overtaken	ow v er t ey k ah n
overtakes	ow v er t ey k s
overtaxed	ow v er t ae k s t
overtook	ow v er t uh k
overwhelmed	ow v er w eh l m d
overwhelming	ow v er w eh l m ih ng
overwrought	ow v er r ao t
owe	ow
owed	ow d
owing	ow ih ng
own	ow n
owner	ow n er
owners	ow n er z
ox	aa k s
pace	p ey s
paced	p ey s t
paces	p ey s ih z
pack	p ae k
packed	p ae k t
padded	p ae d ah d
paddock	p ae d ah k
padlock	p ae d l aa k
paid	p ey d
pain	p ey n
painful	p ey n f ah l
painless	p ey n l ah s
pains	p ey n z
pair	p eh r
pairs	p eh r z
palace	p ae l ah s
palaces	p ae l ah s ih z
paled	p ey l d
pall	p aa l
palm	p aa m
palms	p aa m z
palpable	p ae l p ah b ah l
pandemonium	p ae n d ih m ow n iy ah m
panel	p ae n ah l
panels	p ae n ah l z
pang	p ae ng
panic	p ae n ih k
panorama	p ae n er ae m ah
panting	p ae n t ih ng
paper	p ey p er
papers	p ey p er z
paraded	p er ey d ih d
paralysis	p er ae l ah s ah s
parchment	p aa r ch m ah n t
parent	p eh r ah n t
parents	p eh r ah n t s
park	p aa r k
parks	p aa r k s
parried	p eh r iy d
part	p aa r t
parted	p aa r t ah d
partial	p aa r sh ah l
partiality	p aa r sh iy ae l ah t iy
partially	p aa r sh ah l iy
particular	p er t ih k y ah l er
particularly	p aa r t ih k y ah l er l iy
parting	p aa r t ih ng
partisanship	p aa r t ah z ah n sh ih p
partition	p aa r t ih sh ah n
partitions	p aa r t ih sh ah n z
partly	p aa r t l iy
parts	p aa r t s
party	p aa r t iy
pass	p ae s
passage	p ae s ah jh
passages	p ae s ah jh ah z
passageway	p ae s ah jh w ey
passed	p ae s t
passes	p ae s ah z
passing	p ae s ih ng
passion	p ae sh ah n
past	p ae s t
patched	p ae ch t
patches	p ae ch ah z
patching	p ae ch ih ng
pate	p ey t
path	p ae th
pathetic	p ah th eh t ih k
pathway	p ae th w ey
patrol	p ah t r ow l
patrolled	p ah t r ow l d
patrolling	p ah t r ow l ih ng
patted	p ae t ah d
patterns	p ae t er n z
pause	p ao z
paused	p ao z d
pauses	p ao z ah z
paved	p ey v d
pavement	p ey v m ah n t
paws	p ao z
pay	p ey
peace	p iy s
peak	p iy k
peal	p iy l
peasantry	p eh z ah n t r iy
peculiar	p ah k y uw l y er
peculiarly	p ih k y uw l y er l iy
pedestal	p eh d ah s t ah l
peer	p ih r
peering	p iy r ih ng
pen	p eh n
penalty	p eh n ah l t iy
penetrate	p eh n ah t r ey t
penetrates	p eh n ah t r ey t s
penned	p eh n d
pent	p eh n t
people	p iy p ah l
peopled	p iy p ah l d
peoples	p iy p ah l z
perceive	p er s iy v
perceived	p er s iy v d
perceptible	p er s eh p t ah b ah l
perceptions	p er s eh p sh ah n z
perch	p er ch
perchance	p er ch ae n s
peremptory	p er eh m p t er iy
perfect	p er f eh k t
perfection	p er f eh k sh ah n
perfectly	p er f ah k t l iy
perform	p er f ao r m
performed	p er f ao r m d
perhaps	p er hh ae p s
peril	p eh r ah l
perilous	p eh r ah l ah s
perilously	p eh r ah l ah s l iy
period	p ih r iy ah d
periods	p ih r iy ah d z
periphery	p er ih f er iy
permanently	p er m aa n eh n t l iy
permission	p er m ih sh ah n
permit	p er m ih t
permits	p er m ih t s
permitted	p er m ih t ah d
perpendicular	p er p ah n d ih k y ah l er
perplexed	p er p l eh k s t
persecuted	p er s ah k y uw t ah d
persecution	p er s ah k y uw sh ah n
personal	p er s ih n ah l
personality	p er s ah n ae l ih t iy
personally	p er s ah n ah l iy
personification	p er s aa n ah f ah k ey sh ah n
persons	p er s ah n z
persuade	p er s w ey d
pervading	p er v ey d ih ng
pet	p eh t
petty	p eh t iy
phalanx	f ey l ae ng k s
phase	f ey z
phenomena	f ah n aa m ah n ah
physical	f ih z ih k ah l
pianos	p iy ae n ow z
picked	p ih k t
picking	p ih k ih ng
picture	p ih k ch er
pictured	p ih k ch er d
pictures	p ih k ch er z
piece	p iy s
pieces	p iy s ah z
piecing	p iy s ih ng
pierced	p ih r s t
piercing	p ih r s ih ng
pile	p ay l
piled	p ay l d
piles	p ay l z
pilgrim	p ih l g r ah m
pilgrimage	p ih l g r ah m ah jh
pilgrimages	p ih l g r ah m ih jh ih z
pilot	p ay l ah t
pin	p ih n
pinnacle	p ih n ah k ah l
pirate	p ay r ah t
pirates	p ay r ah t s
pit	p ih t
pitch	p ih ch
pitched	p ih ch t
pitiful	p ih t ah f ah l
pitiless	p ih t iy l ah s
pits	p ih t s
pitted	p ih t ah d
pitying	p ih t iy ih ng
pivot	p ih v ah t
pivoting	p ih v ah t ih ng
pivots	p ih v ah t s
place	p l ey s
placed	p l ey s t
places	p l ey s ah z
placid	p l ae s ah d
placing	p l ey s ih ng
plain	p l ey n
plainly	p l ey n l iy
plains	p l ey n z
plan	p l ae n
plane	p l ey n
planet	p l ae n ah t
planets	p l ae n ah t s
planned	p l ae n d
plans	p l ae n z
plant	p l ae n t
planted	p l ae n t ah d
plants	p l ae n t s
plates	p l ey t s
platform	p l ae t f ao r m
platinum	p l ae t n ah m
plaudits	p l ao d ih t s
played	p l ey d
playground	p l ey g r aw n d
plaything	p l ey th ih ng
playthings	p l ey th ih ng z
plaza	p l aa z ah
plea	p l iy
pleasant	p l eh z ah n t
pleasantly	p l eh z ah n t l iy
please	p l iy z
pleased	p l iy z d
pleases	p l iy z ih z
pleasure	p l eh zh er
pledged	p l eh jh d
plenty	p l eh n t iy
plight	p l ay t
plot	p l aa t
plucked	p l ah k t
plunge	p l ah n jh
plunged	p l ah n jh d
plunging	p l ah n jh ih ng
ply	p l ay
poetic	p ow eh t ih k
poignant	p oy n y ah n t
point	p oy n t
pointed	p oy n t ih d
pointing	p oy n t ih ng
points	p oy n t s
poised	p oy z d
poked	p ow k t
poking	p ow k ih ng
polar	p ow l er
pole	p ow l
poles	p ow l z
policy	p aa l ah s iy
polished	p aa l ih sh t
pollute	p ah l uw t
pondered	p aa n d er d
ponderous	p aa n d er ah s
pool	p uw l
poor	p uw r
populace	p aa p y ah l ah s
popularly	p aa p y ah l er l iy
port	p ao r t
portal	p ao r t ah l
portals	p ao r t ah l z
portend	p ao r t eh n d
portfolio	p ao r t f ow l iy ow
portion	p ao r sh ah n
portions	p ao r sh ah n z
portray	p ao r t r ey
pose	p ow z
position	p ah z ih sh ah n
positions	p ah z ih sh ah n z
positive	p aa z ah t ih v
positively	p aa z ah t ih v l iy
possessed	p ah z eh s t
possession	p ah z eh sh ah n
possessor	p ah z eh s er
possibilities	p aa s ah b ih l ah t iy z
possibility	p aa s ah b ih l ah t iy
possible	p aa s ah b ah l
possibly	p aa s ah b l iy
post	p ow s t
posture	p aa s ch er
potent	p ow t ah n t
pouch	p aw ch
pounced	p aw n s t
pounded	p aw n d ih d
pour	p ao r
poured	p ao r d
pouring	p ao r ih ng
powder	p aw d er
power	p aw er
powerful	p aw er f ah l
powers	p aw er z
practical	p r ae k t ih k ah l
practically	p r ae k t ih k ah l iy
practice	p r ae k t ih s
practised	p r ae k t ih s t
pray	p r ey
prayed	p r ey d
prayer	p r eh r
prayers	p r eh r z
praying	p r ey ih ng
prearranged	p r iy er ey n jh d
precaution	p r iy k ao sh ah n
preceded	p r ih s iy d ih d
precedent	p r eh s ih d ah n t
preceding	p r iy s iy d ih ng
precincts	p r iy s ih ng k t s
precious	p r eh sh ah s
precipitated	p r ih s ih p ih t ey t ih d
precise	p r ih s ay s
precisely	p r ih s ay s l iy
preclude	p r ih k l uw d
precluding	p r ih k l uw d ih ng
predicament	p r ih d ih k ah m ah n t
preference	p r eh f er ah n s
preferred	p r ah f er d
pregnant	p r eh g n ah n t
preparation	p r eh p er ey sh ah n
preparations	p r eh p er ey sh ah n z
prepare	p r iy p eh r
prepared	p r iy p eh r d
preparing	p r iy p eh r ih ng
presaged	p r eh s ih jh d
presence	p r eh z ah n s
present	p r eh z ah n t
presented	p r iy z eh n t ah d
presently	p r eh z ah n t l iy
preservation	p r eh z er v ey sh ah n
preserve	p r ah z er v
presided	p r ih z ay d ih d
presiding	p r ih z ay d ih ng
press	p r eh s
pressed	p r eh s t
pressing	p r eh s ih ng
pressure	p r eh sh er
presume	p r ih z uw m
pretty	p r ih t iy
prevailed	p r ih v ey l d
prevent	p r ih v eh n t
prevented	p r ih v eh n t ih d
previous	p r iy v iy ah s
previously	p r iy v iy ah s l iy
prey	p r ey
preyed	p r ey d
price	p r ay s
priceless	p r ay s l ah s
pride	p r ay d
priest	p r iy s t
priestess	p r iy s t ah s
priests	p r iy s t s
primary	p r ay m eh r iy
prime	p r ay m
prince	p r ih n s
princes	p r ih n s ah z
princess	p r ih n s eh s
princesses	p r ih n s eh s ih z
principal	p r ih n s ah p ah l
principally	p r ih n s ih p l iy
prior	p r ay er
prism	p r ih z ah m
prison	p r ih z ah n
prisoner	p r ih z ah n er
prisoners	p r ih z ah n er z
prisons	p r ih z ah n z
privations	p r ay v ey sh ah n z
privilege	p r ih v ih l ih jh
prize	p r ay z
probability	p r aa b ah b ih l ah t iy
probable	p r aa b ah b ah l
probably	p r aa b ah b l iy
problem	p r aa b l ah m
proceed	p r ah s iy d
proceeded	p r ah s iy d ah d
procession	p r ah s eh sh ah n
proclaims	p r ow k l ey m z
procured	p r ow k y uh r d
prodigious	p r ah d ih jh ah s
produce	p r ah d uw s
produced	p r ah d uw s t
productive	p r ah d ah k t ih v
professed	p r ah f eh s t
profession	p r ah f eh sh ah n
profile	p r ow f ay l
profiles	p r ow f ay l z
profit	p r aa f ah t
profited	p r aa f ah t ah d
profound	p r ow f aw n d
profusion	p r ah f y uw zh ah n
progenitor	p r ow jh eh n ih t er
programme	p r ow g r ae m
progress	p r aa g r eh s
progressed	p r ah g r eh s t
project	p r aa jh eh k t
projectiles	p r aa jh eh k t ah l z
promise	p r aa m ah s
promises	p r aa m ah s ah z
prompted	p r aa m p t ah d
promptly	p r aa m p t l iy
prompts	p r aa m p t s
prone	p r ow n
proof	p r uw f
propeller	p r ah p eh l er
propellers	p r ah p eh l er z
proper	p r aa p er
properly	p r aa p er l iy
property	p r aa p er t iy
propitious	p r ah p ih sh ah s
proportioned	p r ah p ao r sh ah n d
proportions	p r ah p ao r sh ah n z
proposition	p r aa p ah z ih sh ah n
prosecute	p r aa s ah k y uw t
prostrate	p r aa s t r ey t
protect	p r ah t eh k t
protected	p r ah t eh k t ih d
protection	p r ah t eh k sh ah n
protrude	p r ow t r uw d
protruding	p r ow t r uw d ih ng
proud	p r aw d
prove	p r uw v
proved	p r uw v d
proven	p r uw v ah n
proverb	p r aa v er b
providence	p r aa v ah d ah n s
prow	p r aw
prowess	p r aw ah s
prowl	p r aw l
proximity	p r aa k s ih m ah t iy
pruning	p r uw n ih ng
psychological	s ay k ah l aa jh ih k ah l
public	p ah b l ih k
pull	p uh l
pulled	p uh l d
pump	p ah m p
pumping	p ah m p ih ng
pumps	p ah m p s
punctured	p ah ng k ch er d
punish	p ah n ih sh
puny	p y uw n iy
pupil	p y uw p ah l
puppies	p ah p iy z
pure	p y uh r
purity	p y uh r ah t iy
purple	p er p ah l
purpose	p er p ah s
purposes	p er p ah s ah z
purr	p er
purring	p er ih ng
pursue	p er s uw
pursued	p er s uw d
pursuer	p er s uw er
pursuers	p er s uw er z
pursuing	p er s uw ih ng
pursuit	p er s uw t
pushed	p uh sh t
pushing	p uh sh ih ng
put	p uh t
putrid	p y uw t r ih d
puts	p uh t s
puttering	p ah t er ih ng
puzzle	p ah z ah l
puzzled	p ah z ah l d
pygmies	p ih g m iy z
quandary	k w aa n d er iy
quantities	k w aa n t ah t iy z
quantity	k w aa n t ah t iy
quarrel	k w ao r ah l
quarter	k w ao r t er
quarters	k w ao r t er z
quartz	k w ao r t s
queer	k w ih r
quench	k w eh n ch
queries	k w ih r iy z
quest	k w eh s t
question	k w eh s ch ah n
questioned	k w eh s ch ah n d
questioning	k w eh s ch ah n ih ng
questions	k w eh s ch ah n z
quick	k w ih k
quickest	k w ih k ih s t
quickly	k w ih k l iy
quickness	k w ih k n ah s
quiet	k w ay ah t
quietly	k w ay ah t l iy
quite	k w ay t
r	aa r
race	r ey s
raced	r ey s t
races	r ey s ah z
racing	r ey s ih ng
rack	r ae k
racking	r ae k ih ng
racks	r ae k s
radiance	r ey d iy ah n s
radiant	r ey d iy ah n t
radiated	r ey d iy ey t ih d
radio	r ey d iy ow
radium	r ey d iy ah m
radius	r ey d iy ah s
raft	r ae f t
rage	r ey jh
raged	r ey jh d
ragged	r ae g ah d
raging	r ey jh ih ng
raided	r ey d ih d
raids	r ey d z
rail	r ey l
rails	r ey l z
rain	r ey n
rained	r ey n d
rains	r ey n z
raise	r ey z
raised	r ey z d
raises	r ey z ah z
raising	r ey z ih ng
raked	r ey k t
raking	r ey k ih ng
raleigh	r ao l iy
rallied	r ae l iy d
rammed	r ae m d
ramparts	r ae m p aa r t s
ran	r ae n
rang	r ae ng
range	r ey n jh
ranged	r ey n jh d
rank	r ae ng k
ranks	r ae ng k s
rapid	r ae p ah d
rapidity	r ah p ih d ah t iy
rapidly	r ae p ah d l iy
rapped	r ae p t
rare	r eh r
rarefied	r eh r ah f ay d
rash	r ae sh
rasp	r ae s p
rat	r ae t
rate	r ey t
rather	r ae dh er
ratio	r ey sh iy ow
rationality	r ae sh ah n ae l ih t iy
rats	r ae t s
rattled	r ae t ah l d
ravages	r ae v ih jh ih z
raving	r ey v ih ng
ray	r ey
rays	r ey z
razor	r ey z er
re	r ey
reach	r iy ch
reached	r iy ch t
reaches	r iy ch ah z
reaching	r iy ch ih ng
read	r eh d
reader	r iy d er
readily	r eh d ah l iy
readiness	r eh d iy n ah s
reading	r iy d ih ng
ready	r eh d iy
real	r iy l
realised	r iy ah l ay z d
realities	r iy ae l ah t iy z
reality	r iy ae l ah t iy
realization	r iy l ah z ey sh ah n
realize	r iy ah l ay z
realized	r iy ah l ay z d
really	r ih l iy
realm	r eh l m
realms	r eh l m z
reap	r iy p
rear	r ih r
reared	r ih r d
rearing	r ih r ih ng
rearrange	r iy er ey n jh
reason	r iy z ah n
reasonable	r iy z ah n ah b ah l
reasoning	r iy z ah n ih ng
reasserted	r iy ah s er t ah d
reassuring	r iy ah sh uh r ih ng
recall	r iy k ao l
recalled	r ih k ao l d
recapture	r iy k ae p ch er
recaptured	r iy k ae p ch er d
receded	r ah s iy d ah d
receding	r ih s iy d ih ng
receive	r ah s iy v
received	r ah s iy v d
receives	r ah s iy v z
receiving	r ah s iy v ih ng
recent	r iy s ah n t
recently	r iy s ah n t l iy
receptacle	r ah s eh p t ah k ah l
reception	r ih s eh p sh ah n
recesses	r iy s eh s ah z
reciprocate	r ih s ih p r ah k ey t
reciprocated	r ih s ih p r ah k ey t ih d
recitation	r eh s ah t ey sh ah n
reckless	r eh k l ah s
recklessly	r eh k l ah s l iy
reckon	r eh k ah n
reckoned	r eh k ah n d
reclined	r ih k l ay n d
reclining	r ih k l ay n ih ng
recognised	r eh k ah g n ay z d
recognition	r eh k ah g n ih sh ah n
recognize	r eh k ah g n ay z
recognized	r eh k ah g n ay z d
recoiled	r iy k oy l d
recollection	r eh k ah l eh k sh ah n
recompense	r eh k ah m p eh n s
recounting	r ih k aw n t ih ng
recover	r ih k ah v er
recruited	r ih k r uw t ih d
red	r eh d
reddish	r eh d ih sh
redoubled	r iy d ah b ah l d
reds	r eh d z
reduce	r ih d uw s
reduced	r ih d uw s t
reeled	r iy l d
reference	r eh f er ah n s
references	r eh f er ah n s ih z
refinement	r ah f ay n m ah n t
refitting	r iy f ih t ih ng
reflect	r ah f l eh k t
reflected	r ah f l eh k t ah d
reflecting	r ah f l eh k t ih ng
reflection	r ah f l eh k sh ah n
refrain	r ih f r ey n
refreshed	r iy f r eh sh t
refuge	r eh f y uw jh
refusal	r ah f y uw z ah l
refused	r ah f y uw z d
refusing	r ah f y uw z ih ng
regain	r ih g ey n
regained	r iy g ey n d
regaining	r ih g ey n ih ng
regard	r ah g aa r d
regarding	r ah g aa r d ih ng
regardless	r ah g aa r d l ah s
regions	r iy jh ah n z
regret	r ah g r eh t
regretted	r ih g r eh t ih d
regular	r eh g y ah l er
regulated	r eh g y ah l ey t ah d
reigned	r ey n d
rein	r ey n
reinforced	r iy ih n f ao r s t
reject	r ih jh eh k t
rejoicing	r ih jh oy s ih ng
relative	r eh l ah t ih v
release	r iy l iy s
released	r iy l iy s t
releases	r ih l iy s ih z
releasing	r iy l iy s ih ng
relentless	r ih l eh n t l ih s
relief	r ih l iy f
relieved	r ih l iy v d
religion	r ih l ih jh ah n
religions	r iy l ih jh ah n z
religious	r ih l ih jh ah s
relinquish	r ih l ih ng k w ih sh
relish	r eh l ih sh
remain	r ih m ey n
remained	r ih m ey n d
remaining	r ih m ey n ih ng
remains	r ih m ey n z
remarkable	r ih m aa r k ah b ah l
remarkably	r ih m aa r k ah b l iy
remarked	r ih m aa r k t
remember	r ih m eh m b er
remembered	r ih m eh m b er d
remembers	r ih m eh m b er z
remind	r iy m ay n d
reminded	r iy m ay n d ah d
remnant	r eh m n ah n t
remnants	r eh m n ah n t s
remorseless	r ih m ao r s l ah s
remote	r ih m ow t
remotest	r ih m ow t ah s t
removal	r ih m uw v ah l
remove	r iy m uw v
removed	r iy m uw v d
removing	r iy m uw v ih ng
render	r eh n d er
rendered	r eh n d er d
renegade	r eh n ah g ey d
renew	r ih n uw
renewed	r ih n uw d
rent	r eh n t
reopen	r iy ow p ah n
repair	r ih p eh r
repairs	r ih p eh r z
repeated	r ih p iy t ih d
repeating	r ih p iy t ih ng
repelling	r ah p eh l ih ng
repetition	r eh p ah t ih sh ah n
replace	r iy p l ey s
replenish	r iy p l eh n ih sh
replenishment	r ih p l eh n ih sh m ah n t
replicas	r eh p l ih k ah z
replied	r ih p l ay d
reply	r ih p l ay
report	r iy p ao r t
reported	r iy p ao r t ah d
reports	r ih p ao r t s
represent	r eh p r ah z eh n t
representative	r eh p r ah z eh n t ah t ih v
represented	r eh p r ah z eh n t ah d
representing	r eh p r ih z eh n t ih ng
represents	r eh p r ah z eh n t s
repress	r iy p r eh s
repressed	r iy p r eh s t
reprieve	r iy p r iy v
reproduce	r iy p r ah d uw s
reproduced	r iy p r ah d uw s t
repulsed	r iy p ah l s t
repulsive	r iy p ah l s ih v
reputed	r ih p y uw t ih d
request	r ih k w eh s t
requested	r ih k w eh s t ih d
require	r iy k w ay er
required	r iy k w ay er d
requirements	r ih k w ay r m ah n t s
requires	r iy k w ay er z
requiring	r iy k w ay er ih ng
rescue	r eh s k y uw
rescued	r eh s k y uw d
rescuing	r eh s k y uw ih ng
resemblance	r ih z eh m b l ah n s
resemble	r ih z eh m b ah l
resembled	r ih z eh m b ah l d
resentful	r ih z eh n t f ah l
resentment	r ih z eh n t m ah n t
reserved	r ih z er v d
reservoir	r eh z ah v w aa r
reservoirs	r eh z er v w aa r z
residence	r eh z ih d ah n s
resigned	r ih z ay n d
resist	r ih z ih s t
resistance	r ih z ih s t ah n s
resolve	r iy z aa l v
resort	r ih z ao r t
resounding	r iy s aw n d ih ng
resources	r iy s ao r s ih z
respect	r ih s p eh k t
respected	r ih s p eh k t ih d
respective	r ih s p eh k t ih v
respects	r ih s p eh k t s
respiration	r eh s p er ey sh ah n
respite	r eh s p ih t
resplendent	r iy s p l eh n d ah n t
respond	r ih s p aa n d
responded	r ih s p aa n d ih d
response	r ih s p aa n s
responsibility	r iy s p aa n s ah b ih l ah t iy
rest	r eh s t
rested	r eh s t ah d
resting	r eh s t ih ng
restlessly	r eh s t l ah s l iy
rests	r eh s t s
result	r ih z ah l t
resulted	r ih z ah l t ih d
results	r ih z ah l t s
resume	r ih z uw m
resumed	r ih z uw m d
resurrection	r eh z er eh k sh ah n
retain	r ih t ey n
retained	r ih t ey n d
retarded	r ih t aa r d ih d
retinue	r eh t ah n uw
retired	r ih t ay r d
retorted	r iy t ao r t ih d
retrace	r iy t r ey s
retraced	r iy t r ey s t
retreat	r iy t r iy t
retreated	r iy t r iy t ah d
retreating	r iy t r iy t ih ng
retribution	r eh t r ah b y uw sh ah n
return	r ih t er n
returned	r ih t er n d
returning	r ih t er n ih ng
returns	r ih t er n z
reveal	r ih v iy l
revealed	r ih v iy l d
revealing	r ih v iy l ih ng
revelations	r eh v ah l ey sh ah n z
revenge	r iy v eh n jh
reverberating	r ih v er b er ey t ih ng
reverence	r eh v er ah n s
reveries	r eh v er iy z
reverse	r ih v er s
reversed	r ih v er s t
reviled	r iy v ay l d
revolution	r eh v ah l uw sh ah n
revolve	r iy v aa l v
revolver	r ih v aa l v er
revolvers	r ih v aa l v er z
revolves	r iy v aa l v z
revolving	r iy v aa l v ih ng
reward	r ih w ao r d
rewarded	r ih w ao r d ih d
rewards	r ih w ao r d z
rhythm	r ih dh ah m
rhythmic	r ih dh m ih k
ribbon	r ih b ah n
ribbons	r ih b ah n z
ribs	r ih b z
rich	r ih ch
richer	r ih ch er
riches	r ih ch ah z
richly	r ih ch l iy
richmond	r ih ch m ah n d
ridding	r ih d ih ng
rider	r ay d er
riders	r ay d er z
ridiculous	r ih d ih k y ah l ah s
riding	r ay d ih ng
rife	r ay f
rifle	r ay f ah l
rifles	r ay f ah l z
rift	r ih f t
right	r ay t
righteous	r ay ch ah s
righteousness	r ay ch ah s n ah s
rightful	r ay t f ah l
rights	r ay t s
rimmed	r ih m d
ring	r ih ng
ringing	r ih ng ih ng
rings	r ih ng z
rise	r ay z
risen	r ih z ah n
rising	r ay z ih ng
risk	r ih s k
risking	r ih s k ih ng
rites	r ay t s
river	r ih v er
rivers	r ih v er z
riveted	r ih v ah t ih d
road	r ow d
roads	r ow d z
roam	r ow m
roamed	r ow m d
roams	r ow m z
roar	r ao r
roared	r ao r d
roars	r ao r z
rob	r aa b
robbed	r aa b d
robe	r ow b
robes	r ow b z
rock	r aa k
rocked	r aa k t
rocks	r aa k s
rocky	r aa k iy
rode	r ow d
roll	r ow l
rolled	r ow l d
rolling	r ow l ih ng
romantic	r ow m ae n t ih k
roof	r uw f
roofs	r uw f s
room	r uw m
rooms	r uw m z
root	r uw t
rope	r ow p
rose	r ow z
rostrum	r aa s t r ah m
rot	r aa t
rough	r ah f
roughly	r ah f l iy
round	r aw n d
roundabout	r aw n d ah b aw t
rounded	r aw n d ah d
rounds	r aw n d z
roused	r aw z d
route	r uw t
rows	r ow z
royal	r oy ah l
rubbed	r ah b d
rubies	r uw b iy z
ruby	r uw b iy
rude	r uw d
rule	r uw l
rumour	r uw m er
rumours	r uw m er z
rump	r ah m p
run	r ah n
running	r ah n ih ng
runs	r ah n z
runway	r ah n w ey
ruse	r uw z
rush	r ah sh
rushed	r ah sh t
rushing	r ah sh ih ng
rustling	r ah s l ih ng
rusty	r ah s t iy
ruthlessly	r uw th l ah s l iy
s	eh s
sacred	s ey k r ah d
sacrifice	s ae k r ah f ay s
sacrificed	s ae k r ah f ay s t
sacrilege	s ae k r ah l ah jh
sacrilegious	s ae k r ah l eh jh ih s
sad	s ae d
saddened	s ae d ah n d
sadly	s ae d l iy
sadness	s ae d n ah s
safe	s ey f
safely	s ey f l iy
safer	s ey f er
safety	s ey f t iy
sagged	s ae g d
said	s eh d
sail	s ey l
sailed	s ey l d
sailing	s ey l ih ng
sailor	s ey l er
sailors	s ey l er z
sake	s ey k
salute	s ah l uw t
saluted	s ah l uw t ah d
salvation	s ae l v ey sh ah n
salves	s aa v z
same	s ey m
sanctity	s ae ng k t ih t iy
sanctuary	s ae ng k ch uw eh r iy
sand	s ae n d
sanitation	s ae n ah t ey sh ah n
sank	s ae ng k
sap	s ae p
sapphire	s ae f ay er
sardonic	s aa r d aa n ih k
sat	s ae t
satellite	s ae t ah l ay t
satisfaction	s ae t ah s f ae k sh ah n
satisfied	s ae t ah s f ay d
satisfy	s ae t ah s f ay
savage	s ae v ah jh
savages	s ae v ah jh ah z
save	s ey v
saved	s ey v d
saving	s ey v ih ng
saw	s ao
say	s ey
saying	s ey ih ng
says	s eh z
scabbard	s k ae b er d
scale	s k ey l
scaling	s k ey l ih ng
scalp	s k ae l p
scant	s k ae n t
scarce	s k eh r s
scarcely	s k eh r s l iy
scare	s k eh r
scared	s k eh r d
scarlet	s k aa r l ah t
scattered	s k ae t er d
scavengers	s k ae v ah n jh er z
scene	s iy n
scenes	s iy n z
scent	s eh n t
scented	s eh n t ih d
scheme	s k iy m
schooled	s k uw l d
science	s ay ah n s
scientific	s ay ah n t ih f ih k
scoffs	s k ao f s
scope	s k ow p
score	s k ao r
scores	s k ao r z
scorn	s k ao r n
scoured	s k aw er d
scout	s k aw t
scouts	s k aw t s
scowl	s k aw l
scowling	s k aw l ih ng
scrambled	s k r ae m b ah l d
scrambling	s k r ae m b ah l ih ng
scraped	s k r ey p t
scraping	s k r ey p ih ng
scraps	s k r ae p s
scratch	s k r ae ch
scratched	s k r ae ch t
scream	s k r iy m
screamed	s k r iy m d
screaming	s k r iy m ih ng
screams	s k r iy m z
screeched	s k r iy ch t
screeching	s k r iy ch ih ng
scrutinizing	s k r uw t ah n ay z ih ng
scrutiny	s k r uw t ah n iy
scurrying	s k er iy ih ng
sea	s iy
seal	s iy l
sealed	s iy l d
sealing	s iy l ih ng
seaman	s iy m ah n
seamen	s iy m ah n
search	s er ch
searchers	s er ch er z
searching	s er ch ih ng
searchlight	s er ch l ay t
seas	s iy z
seasoned	s iy z ah n d
seat	s iy t
seated	s iy t ah d
seats	s iy t s
second	s eh k ah n d
seconds	s eh k ah n d z
secrecy	s iy k r ah s iy
secret	s iy k r ah t
secrete	s ih k r iy t
secretly	s iy k r ih t l iy
secrets	s iy k r ih t s
section	s eh k sh ah n
sections	s eh k sh ah n z
secure	s ih k y uh r
secured	s ih k y uh r d
securely	s ih k y uh r l iy
security	s ih k y uh r ah t iy
see	s iy
seeing	s iy ih ng
seek	s iy k
seeking	s iy k ih ng
seem	s iy m
seemed	s iy m d
seemingly	s iy m ih ng l iy
seems	s iy m z
seen	s iy n
sees	s iy z
seethe	s iy dh
seething	s iy dh ih ng
seize	s iy z
seized	s iy z d
seizing	s iy z ih ng
seldom	s eh l d ah m
select	s ah l eh k t
selected	s ah l eh k t ah d
selection	s ah l eh k sh ah n
selects	s ah l eh k t s
self	s eh l f
selling	s eh l ih ng
semblance	s eh m b l ah n s
semi	s eh m iy
send	s eh n d
sends	s eh n d z
sensation	s eh n s ey sh ah n
sensations	s eh n s ey sh ah n z
sense	s eh n s
sensed	s eh n s t
senseless	s eh n s l ah s
senses	s eh n s ih z
sensibilities	s eh n s ih b ih l ih t iy z
sent	s eh n t
sentence	s eh n t ah n s
sentences	s eh n t ah n s ah z
sentiment	s eh n t ah m ah n t
sentiments	s eh n t ah m ah n t s
sentries	s eh n t r iy z
sentry	s eh n t r iy
separate	s eh p er ey t
separated	s eh p er ey t ah d
separating	s eh p er ey t ih ng
series	s ih r iy z
serious	s ih r iy ah s
servant	s er v ah n t
servants	s er v ah n t s
serve	s er v
served	s er v d
serves	s er v z
service	s er v ah s
services	s er v ah s ah z
servile	s er v ah l
serving	s er v ih ng
set	s eh t
sets	s eh t s
setting	s eh t ih ng
settle	s eh t ah l
settled	s eh t ah l d
seven	s eh v ah n
seventy	s eh v ah n t iy
several	s eh v er ah l
severe	s ah v ih r
severed	s eh v er d
sexes	s eh k s ah z
shabby	sh ae b iy
shade	sh ey d
shading	sh ey d ih ng
shadow	sh ae d ow
shadows	sh ae d ow z
shadowy	sh ae d ow iy
shaft	sh ae f t
shakes	sh ey k s
shall	sh ae l
shalt	sh ae l t
shape	sh ey p
shaped	sh ey p t
shapes	sh ey p s
share	sh eh r
shared	sh eh r d
sharp	sh aa r p
shatter	sh ae t er
shattered	sh ae t er d
shattering	sh ae t er ih ng
she	sh iy
sheepish	sh iy p ih sh
sheer	sh ih r
shell	sh eh l
shells	sh eh l z
shelter	sh eh l t er
sheltering	sh eh l t er ih ng
shields	sh iy l d z
shimmer	sh ih m er
shimmering	sh ih m er ih ng
shin	sh ih n
shining	sh ay n ih ng
shiny	sh ay n iy
ship	sh ih p
ships	sh ih p s
shirk	sh er k
shivers	sh ih v er z
shock	sh aa k
shod	sh aa d
shook	sh uh k
shore	sh ao r
shores	sh ao r z
short	sh ao r t
shortening	sh ao r t ah n ih ng
shorter	sh ao r t er
shortest	sh ao r t ih s t
shortly	sh ao r t l iy
shot	sh aa t
shots	sh aa t s
should	sh uh d
shoulder	sh ow l d er
shoulders	sh ow l d er z
shout	sh aw t
shouted	sh aw t ah d
shouting	sh aw t ih ng
shouts	sh aw t s
shove	sh ah v
show	sh ow
showed	sh ow d
showing	sh ow ih ng
shown	sh ow n
shrank	sh r ae ng k
shrewdest	sh r uw d ah s t
shriek	sh r iy k
shrieked	sh r iy k t
shrieking	sh r iy k ih ng
shrieks	sh r iy k s
shrift	sh r ih f t
shrill	sh r ih l
shrink	sh r ih ng k
shrouded	sh r aw d ih d
shrubbery	sh r ah b er iy
shrubs	sh r ah b z
shrug	sh r ah g
shrugged	sh r ah g d
shudder	sh ah d er
shuddered	sh ah d er d
shuddering	sh ah d er ih ng
shuffling	sh ah f l ih ng
shut	sh ah t
shutting	sh ah t ih ng
sickening	s ih k ah n ih ng
side	s ay d
sides	s ay d z
sidestepped	s ay d s t eh p t
sidestepping	s ay d s t eh p ih ng
siege	s iy jh
sigh	s ay
sight	s ay t
sighted	s ay t ah d
sights	s ay t s
sign	s ay n
signal	s ih g n ah l
signalled	s ih g n ah l d
signals	s ih g n ah l z
signed	s ay n d
significance	s ah g n ih f ih k ah n s
significant	s ah g n ih f ih k ah n t
signified	s ih g n ah f ay d
signs	s ay n z
silence	s ay l ah n s
silent	s ay l ah n t
silently	s ay l ah n t l iy
silk	s ih l k
silks	s ih l k s
sill	s ih l
silver	s ih l v er
silvery	s ih l v er iy
similar	s ih m ah l er
similarly	s ih m ah l er l iy
simple	s ih m p ah l
simpler	s ih m p ah l er
simplest	s ih m p l ah s t
simply	s ih m p l iy
simultaneously	s ay m ah l t ey n iy ah s l iy
sin	s ih n
since	s ih n s
sincere	s ih n s ih r
sinewy	s ih n y uw iy
single	s ih ng g ah l
singly	s ih ng g l iy
singular	s ih ng g y ah l er
sinister	s ih n ih s t er
sink	s ih ng k
sinking	s ih ng k ih ng
sins	s ih n z
sinuous	s ih n w ah s
sire	s ay er
sires	s ay r z
sister	s ih s t er
sits	s ih t s
sitting	s ih t ih ng
situated	s ih ch uw ey t ih d
situation	s ih ch uw ey sh ah n
six	s ih k s
sixteen	s ih k s t iy n
sixty	s ih k s t iy
size	s ay z
sized	s ay z d
sizes	s ay z ah z
skeel	s k iy l
skeletons	s k eh l ah t ah n z
sketch	s k eh ch
skies	s k ay z
skill	s k ih l
skimmed	s k ih m d
skin	s k ih n
skinned	s k ih n d
skins	s k ih n z
skipping	s k ih p ih ng
skirt	s k er t
skirted	s k er t ih d
skull	s k ah l
sky	s k ay
slack	s l ae k
slain	s l ey n
slammed	s l ae m d
slapped	s l ae p t
slash	s l ae sh
slate	s l ey t
slaughter	s l ao t er
slave	s l ey v
slaves	s l ey v z
slay	s l ey
sleek	s l iy k
sleep	s l iy p
sleeper	s l iy p er
sleepers	s l iy p er z
sleeping	s l iy p ih ng
slender	s l eh n d er
slept	s l eh p t
slew	s l uw
slid	s l ih d
slight	s l ay t
slightest	s l ay t ah s t
slightly	s l ay t l iy
slimy	s l ay m iy
slinging	s l ih ng ih ng
slip	s l ih p
slipped	s l ih p t
slipping	s l ih p ih ng
slits	s l ih t s
slope	s l ow p
slopes	s l ow p s
slow	s l ow
slower	s l ow er
slowest	s l ow ah s t
slowing	s l ow ih ng
slowly	s l ow l iy
sluggish	s l ah g ih sh
slumber	s l ah m b er
small	s m ao l
smaller	s m ao l er
smallest	s m ao l ah s t
smeared	s m ih r d
smell	s m eh l
smile	s m ay l
smiled	s m ay l d
smiles	s m ay l z
smiling	s m ay l ih ng
smitten	s m ih t ah n
smoke	s m ow k
smooth	s m uw dh
smoothest	s m uw dh ah s t
smoothness	s m uw dh n ah s
smothered	s m ah dh er d
snail	s n ey l
snake	s n ey k
snakelike	s n ey k l ay k
snap	s n ae p
snapped	s n ae p t
snapping	s n ae p ih ng
snarl	s n aa r l
snarled	s n aa r ah l d
snarling	s n aa r l ih ng
snarls	s n aa r l z
snatched	s n ae ch t
snatching	s n ae ch ih ng
sneak	s n iy k
sneaking	s n iy k ih ng
sneer	s n ih r
sniffed	s n ih f t
sniffing	s n ih f ih ng
snouts	s n aw t s
snow	s n ow
snows	s n ow z
snuffed	s n ah f t
so	s ow
soared	s ao r d
soaring	s ao r ih ng
sobbed	s aa b d
social	s ow sh ah l
society	s ow s ay ih t iy
socket	s aa k ah t
sockets	s aa k ah t s
soft	s aa f t
softly	s ao f t l iy
sola	s ow l ah
solar	s ow l er
soldier	s ow l jh er
soldiers	s ow l jh er z
sole	s ow l
solely	s ow ah l iy
solemn	s aa l ah m
solid	s aa l ah d
solution	s ah l uw sh ah n
solve	s aa l v
some	s ah m
something	s ah m th ih ng
sometimes	s ah m t ay m z
somewhat	s ah m w ah t
somewhere	s ah m w eh r
son	s ah n
soon	s uw n
sooner	s uw n er
soothing	s uw dh ih ng
soothingly	s uw dh ih ng l iy
sores	s ao r z
sorrow	s aa r ow
sorrows	s aa r ow z
sorry	s aa r iy
sort	s ao r t
sought	s ao t
soul	s ow l
souls	s ow l z
sound	s aw n d
sounded	s aw n d ih d
sounds	s aw n d z
source	s ao r s
south	s aw th
southern	s ah dh er n
southerner	s ah dh er n er
southernmost	s ah dh er n m ow s t
southwest	s aw th w eh s t
space	s p ey s
spacious	s p ey sh ah s
span	s p ae n
spanned	s p ae n d
spared	s p eh r d
sparkled	s p aa r k ah l d
sparkling	s p aa r k l ih ng
sparks	s p aa r k s
spasmodic	s p ae z m ao d ih k
spat	s p ae t
speak	s p iy k
speaker	s p iy k er
speaking	s p iy k ih ng
speaks	s p iy k s
spear	s p ih r
special	s p eh sh ah l
species	s p iy sh iy z
specimen	s p eh s ah m ah n
specimens	s p eh s ah m ah n z
spectacle	s p eh k t ah k ah l
spectators	s p eh k t ey t er z
spectre	s p eh k t er
speculate	s p eh k y ah l ey t
speculation	s p eh k y ah l ey sh ah n
sped	s p eh d
speed	s p iy d
speeding	s p iy d ih ng
speedy	s p iy d iy
spell	s p eh l
spend	s p eh n d
spent	s p eh n t
spied	s p ay d
spies	s p ay z
spine	s p ay n
spiral	s p ay r ah l
spire	s p ay r
spires	s p ay r z
spirit	s p ih r ah t
spirits	s p ih r ih t s
splashed	s p l ae sh t
splendid	s p l eh n d ih d
splendidly	s p l eh n d ah d l iy
split	s p l ih t
spoils	s p oy l z
spoke	s p ow k
spoken	s p ow k ah n
sport	s p ao r t
spot	s p aa t
spots	s p aa t s
sprang	s p r ae ng
sprawled	s p r ao l d
spread	s p r eh d
spreading	s p r eh d ih ng
spring	s p r ih ng
springing	s p r ih ng ih ng
sprung	s p r ah ng
spun	s p ah n
spurn	s p er n
spurned	s p er n d
spurred	s p er d
spurt	s p er t
spurts	s p er t s
spy	s p ay
spying	s p ay ih ng
square	s k w eh r
squarely	s k w eh r l iy
squares	s k w eh r z
squatting	s k w aa t ih ng
squealing	s k w iy l ih ng
squeals	s k w iy l z
staccato	s t ah k aa t ow
stage	s t ey jh
stages	s t ey jh ih z
staggered	s t ae g er d
stairs	s t eh r z
stairway	s t eh r w ey
stake	s t ey k
stalked	s t ao k t
stamped	s t ae m p t
stampede	s t ae m p iy d
stamping	s t ae m p ih ng
stand	s t ae n d
standards	s t ae n d er d z
standing	s t ae n d ih ng
stands	s t ae n d z
star	s t aa r
starboard	s t aa r b er d
stared	s t eh r d
staring	s t eh r ih ng
stars	s t aa r z
start	s t aa r t
started	s t aa r t ah d
starting	s t aa r t ih ng
startled	s t aa r t ah l d
starvation	s t aa r v ey sh ah n
starved	s t aa r v d
starving	s t aa r v ih ng
statement	s t ey t m ah n t
statements	s t ey t m ah n t s
states	s t ey t s
statesman	s t ey t s m ah n
stating	s t ey t ih ng
station	s t ey sh ah n
stationed	s t ey sh ah n d
stations	s t ey sh ah n z
statue	s t ae ch uw
stature	s t ae ch er
stay	s t ey
stayed	s t ey d
stead	s t eh d
steadily	s t eh d ah l iy
steal	s t iy l
stealth	s t eh l th
stealthy	s t eh l th iy
steed	s t iy d
steel	s t iy l
steep	s t iy p
steeped	s t iy p t
steeper	s t iy p er
steer	s t ih r
steered	s t ih r d
steering	s t ih r ih ng
stem	s t eh m
stemmed	s t eh m d
stems	s t eh m z
step	s t eh p
stepped	s t eh p t
stepping	s t eh p ih ng
steps	s t eh p s
stern	s t er n
sterner	s t er n er
sticky	s t ih k iy
stiff	s t ih f
stiffened	s t ih f ah n d
stiffly	s t ih f l iy
stifling	s t ay f l ih ng
still	s t ih l
stillness	s t ih l n ah s
stirred	s t er d
stoicism	s t ow ah s ih z ah m
stole	s t ow l
stolen	s t ow l ah n
stone	s t ow n
stones	s t ow n z
stony	s t ow n iy
stood	s t uh d
stoop	s t uw p
stooped	s t uw p t
stooping	s t uw p ih ng
stop	s t aa p
stopped	s t aa p t
stopping	s t aa p ih ng
storehouse	s t ao r hh aw s
storeroom	s t ao r r uw m
story	s t ao r iy
stragglers	s t r ae g l er z
straight	s t r ey t
strain	s t r ey n
strained	s t r ey n d
strands	s t r ae n d z
strange	s t r ey n jh
strangely	s t r ey n jh l iy
strangeness	s t r ey n jh n ah s
strangest	s t r ey n jh ih s t
strangle	s t r ae ng g ah l
strap	s t r ae p
stratagem	s t r ae t ah jh ah m
strategy	s t r ae t ah jh iy
stratum	s t r ae t ah m
stray	s t r ey
straying	s t r ey ih ng
streaked	s t r iy k t
streaks	s t r iy k s
stream	s t r iy m
streaming	s t r iy m ih ng
streets	s t r iy t s
strength	s t r eh ng k th
stretched	s t r eh ch t
stretches	s t r eh ch ah z
stretching	s t r eh ch ih ng
strewn	s t r uw n
stricken	s t r ih k ah n
strict	s t r ih k t
stride	s t r ay d
strife	s t r ay f
strike	s t r ay k
striking	s t r ay k ih ng
string	s t r ih ng
strip	s t r ih p
stripped	s t r ih p t
stripping	s t r ih p ih ng
strode	s t r ow d
stroke	s t r ow k
strokes	s t r ow k s
stroll	s t r ow l
strolling	s t r ow l ih ng
strong	s t r ao ng
stronghold	s t r ao ng hh ow l d
strongly	s t r ao ng l iy
struck	s t r ah k
structure	s t r ah k ch er
struggle	s t r ah g ah l
struggled	s t r ah g ah l d
struggles	s t r ah g ah l z
struggling	s t r ah g ah l ih ng
strung	s t r ah ng
stubborn	s t ah b er n
stuck	s t ah k
studded	s t ah d ih d
studied	s t ah d iy d
study	s t ah d iy
stuff	s t ah f
stumble	s t ah m b ah l
stumbled	s t ah m b ah l d
stumbling	s t ah m b ah l ih ng
stunned	s t ah n d
stupid	s t uw p ah d
stupidity	s t uw p ih d ih t iy
stupidly	s t uw p ah d l iy
stygian	s t ih jh iy ah n
style	s t ay l
subconscious	s ah b k aa n sh ah s
subdued	s ah b d uw d
subject	s ah b jh eh k t
subjects	s ah b jh ih k t s
submarine	s ah b m er iy n
submerge	s ah b m er jh
submerged	s ah b m er jh d
submission	s ah b m ih sh ah n
submit	s ah b m ih t
subordinates	s ah b ao r d ah n ey t s
subsequent	s ah b s ah k w ah n t
substance	s ah b s t ah n s
substantial	s ah b s t ae n sh ah l
subterfuge	s ah b t er f y uw jh
subterranean	s ah b t er ey n iy ah n
subtle	s ah t ah l
succeed	s ah k s iy d
succeeded	s ah k s iy d ah d
success	s ah k s eh s
successful	s ah k s eh s f ah l
succession	s ah k s eh sh ah n
succumb	s ah k ah m
such	s ah ch
sucking	s ah k ih ng
sudden	s ah d ah n
suddenly	s ah d ah n l iy
suffer	s ah f er
suffered	s ah f er d
suffering	s ah f er ih ng
sufficient	s ah f ih sh ah n t
sufficiently	s ah f ih sh ah n t l iy
suffocating	s ah f ah k ey t ih ng
suffused	s ah f y uw z d
suggest	s ah jh eh s t
suggested	s ah jh eh s t ah d
suggestion	s ah jh eh s ch ah n
suitable	s uw t ah b ah l
sullen	s ah l ah n
sultry	s ah l t r iy
sum	s ah m
summer	s ah m er
summit	s ah m ah t
summits	s ah m ih t s
summoned	s ah m ah n d
summoning	s ah m ah n ih ng
summons	s ah m ah n z
sumptuous	s ah m p ch w ah s
sun	s ah n
sundown	s ah n d aw n
sunk	s ah ng k
sunken	s ah ng k ah n
sunlight	s ah n l ay t
super	s uw p er
superhuman	s uw p er hh y uw m ah n
supernatural	s uw p er n ae ch er ah l
superstition	s uw p er s t ih sh ah n
superstitions	s uw p er s t ih sh ah n z
superstitious	s uw p er s t ih sh ah s
supply	s ah p l ay
support	s ah p ao r t
supported	s ah p ao r t ah d
supporting	s ah p ao r t ih ng
supposed	s ah p ow z d
supposedly	s ah p ow z ah d l iy
supremacy	s ah p r eh m ah s iy
supreme	s ah p r iy m
surcease	s er s iy s
sure	sh uh r
surely	sh uh r l iy
surface	s er f ah s
surfaces	s er f ah s ah z
surge	s er jh
surged	s er jh d
surging	s er jh ih ng
surprise	s er p r ay z
surprised	s er p r ay z d
surrender	s er eh n d er
surreptitious	s er ah p t ih sh ah s
surround	s er aw n d
surrounded	s er aw n d ah d
surrounding	s er aw n d ih ng
surroundings	s er aw n d ih ng z
surrounds	s er aw n d z
survey	s er v ey
surveyed	s er v ey d
survival	s er v ay v ah l
survive	s er v ay v
survived	s er v ay v d
survivors	s er v ay v er z
suspended	s ah s p eh n d ah d
suspense	s ah s p eh n s
suspicion	s ah s p ih sh ah n
suspicious	s ah s p ih sh ah s
sustain	s ah s t ey n
sustenance	s ah s t ah n ah n s
swallowed	s w aa l ow d
swam	s w ae m
sward	s w ao r d
swarm	s w ao r m
swarmed	s w ao r m d
swarming	s w ao r m ih ng
swathed	s w aa dh d
swayed	s w ey d
sweep	s w iy p
sweet	s w iy t
sweetest	s w iy t ah s t
swelled	s w eh l d
swelling	s w eh l ih ng
swells	s w eh l z
swept	s w eh p t
swift	s w ih f t
swifter	s w ih f t er
swiftest	s w ih f t ah s t
swiftly	s w ih f t l iy
swiftness	s w ih f t n ah s
swim	s w ih m
swimmers	s w ih m er z
swimming	s w ih m ih ng
swing	s w ih ng
swinging	s w ih ng ih ng
swirled	s w er l d
swirling	s w er l ih ng
swooned	s w uw n d
swooped	s w uw p t
sword	s ao r d
swords	s ao r d z
swore	s w ao r
sworn	s w ao r n
swung	s w ah ng
symmetrically	s ah m eh t r ih k l iy
sympathy	s ih m p ah th iy
syrup	s er ah p
system	s ih s t ah m
systematic	s ih s t ah m ae t ih k
t	t iy
table	t ey b ah l
tables	t ey b ah l z
tail	t ey l
tails	t ey l z
take	t ey k
taken	t ey k ah n
takes	t ey k s
taking	t ey k ih ng
tal	t aa l
tale	t ey l
talk	t ao k
talked	t ao k t
talking	t ao k ih ng
talons	t ae l ah n z
tan	t ae n
tangible	t ae n jh ah b ah l
tangled	t ae ng g ah l d
tank	t ae ng k
tanks	t ae ng k s
tantalizing	t ae n t ah l ay z ih ng
tapering	t ey p er ih ng
tapping	t ae p ih ng
taps	t ae p s
tardy	t aa r d iy
target	t aa r g ah t
task	t ae s k
taste	t ey s t
tasted	t ey s t ah d
taught	t ao t
taunting	t ao n t ih ng
taut	t ao t
tawny	t aa n iy
teach	t iy ch
teaches	t iy ch ah z
teaching	t iy ch ih ng
tear	t eh r
tearing	t eh r ih ng
tears	t eh r z
tedious	t iy d iy ah s
teeth	t iy th
telegram	t eh l ah g r ae m
telepathic	t eh l ah p ae th ah k
tell	t eh l
telling	t eh l ih ng
temerity	t ah m eh r ah t iy
temper	t eh m p er
tempered	t eh m p er d
temple	t eh m p ah l
temples	t eh m p ah l z
temporarily	t eh m p er eh r ah l iy
temporary	t eh m p er eh r iy
tempted	t eh m p t ah d
tempting	t eh m p t ih ng
ten	t eh n
tenaciously	t ah n ey sh ah s l iy
tenacity	t ah n ae s ih t iy
tended	t eh n d ah d
tender	t eh n d er
tends	t eh n d z
tens	t eh n z
tense	t eh n s
tentacle	t eh n t ah k ah l
tenth	t eh n th
terminated	t er m ah n ey t ah d
terminates	t er m ih n ey t s
terminating	t er m ah n ey t ih ng
terms	t er m z
terrible	t eh r ah b ah l
terribly	t eh r ah b l iy
terrier	t eh r iy er
terriers	t eh r iy er z
terrific	t er ih f ih k
terrified	t eh r ah f ay d
terrifying	t eh r ah f ay ih ng
territories	t eh r ah t ao r iy z
territory	t eh r ih t ao r iy
terror	t eh r er
terrorize	t eh r ah r ay z
terrorized	t eh r ah r ay z d
terrorizing	t eh r ah r ay z ih ng
terrors	t eh r ah r z
test	t eh s t
testified	t eh s t ih f ay d
testimony	t eh s t ih m ow n iy
th	t iy ey ch
than	dh ae n
thank	th ae ng k
thanked	th ae ng k t
thanksgiving	th ae ng k s g ih v ih ng
that	dh ae t
the	dh ah
theatre	th iy ah t er
thee	dh iy
their	dh eh r
theirs	dh eh r z
them	dh eh m
themselves	dh eh m s eh l v z
then	dh eh n
there	dh eh r
thereafter	dh eh r ae f t er
thereby	dh eh r b ay
therefore	dh eh r f ao r
these	dh iy z
they	dh ey
thick	th ih k
thicker	th ih k er
thickly	th ih k l iy
thigh	th ay
thin	th ih n
thine	dh ay n
thing	th ih ng
things	th ih ng z
think	th ih ng k
thinking	th ih ng k ih ng
thinks	th ih ng k s
thinned	th ih n d
third	th er d
thirst	th er s t
thirty	th er d iy
this	dh ih s
thoroughly	th er ow l iy
those	dh ow z
thou	dh aw
though	dh ow
thought	th ao t
thoughtless	th ao t l ah s
thoughts	th ao t s
thousand	th aw z ah n d
thousands	th aw z ah n d z
thousandth	th aw z ah n d th
thread	th r eh d
threaded	th r eh d ah d
threading	th r eh d ih ng
threaten	th r eh t ah n
threatened	th r eh t ah n d
threatening	th r eh t ah n ih ng
threateningly	th r eh t ah n ih ng l iy
threats	th r eh t s
three	th r iy
threshold	th r eh sh ow l d
threw	th r uw
thrice	th r ay s
thrill	th r ih l
thrills	th r ih l z
throat	th r ow t
throats	th r ow t s
throne	th r ow n
throng	th r ao ng
throttling	th r aa t ah l ih ng
through	th r uw
throughout	th r uw aw t
throw	th r ow
throwing	th r ow ih ng
thrown	th r ow n
throws	th r ow z
thrust	th r ah s t
thrusting	th r ah s t ih ng
thrusts	th r ah s t s
thumb	th ah m
thunderous	th ah n d er ah s
thus	dh ah s
thwart	th w ao r t
thwarted	th w ao r t ah d
thy	dh ay
thyself	dh ay s eh l f
tide	t ay d
tied	t ay d
tier	t iy r
tiers	t iy r z
ties	t ay z
tiger	t ay g er
tight	t ay t
tighten	t ay t ah n
tightened	t ay t ah n d
tightening	t ay t ah n ih ng
tightly	t ay t l iy
till	t ih l
tilted	t ih l t ah d
tilting	t ih l t ih ng
time	t ay m
times	t ay m z
timing	t ay m ih ng
tiniest	t ay n iy ah s t
tiny	t ay n iy
tip	t ih p
tire	t ay er
tired	t ay er d
tiring	t ay r ih ng
tis	t ih z
tissue	t ih s y uw
titanic	t ay t ae n ih k
title	t ay t ah l
titles	t ay t ah l z
to	t uw
toe	t ow
toes	t ow z
together	t ah g eh dh er
token	t ow k ah n
told	t ow l d
toll	t ow l
tomb	t uw m
tomorrow	t ah m aa r ow
tone	t ow n
toned	t ow n d
tones	t ow n z
tongue	t ah ng
tons	t ah n z
too	t uw
took	t uh k
tools	t uw l z
toothless	t uw th l ah s
top	t aa p
topped	t aa p t
topping	t aa p ih ng
toppled	t aa p ah l d
toppling	t aa p ah l ih ng
tops	t aa p s
torch	t ao r ch
tore	t ao r
tormentors	t ao r m eh n t er z
torn	t ao r n
torrent	t ao r ah n t
torso	t ao r s ow
tortuous	t ao r ch ah w ah s
torture	t ao r ch er
tortured	t ao r ch er d
tortures	t ao r ch er z
tossed	t ao s t
tossing	t ao s ih ng
total	t ow t ah l
touch	t ah ch
touched	t ah ch t
touches	t ah ch ah z
toward	t ah w ao r d
towards	t ah w ao r d z
towed	t ow d
tower	t aw er
towered	t aw er d
towering	t aw er ih ng
trace	t r ey s
traced	t r ey s t
traces	t r ey s ah z
tracks	t r ae k s
tradition	t r ah d ih sh ah n
traditions	t r ah d ih sh ah n z
tragedy	t r ae jh ah d iy
trail	t r ey l
trailed	t r ey l d
trailing	t r ey l ih ng
train	t r ey n
trained	t r ey n d
traitor	t r ey t er
trampled	t r ae m p ah l d
tramples	t r ae m p ah l z
trampling	t r ae m p l ih ng
transcend	t r ae n s eh n d
transcended	t r ae n s eh n d ih d
transferred	t r ae n s f er d
transformed	t r ae n s f ao r m d
translate	t r ae n z l ey t
translated	t r ae n z l ey t ah d
transmission	t r ae n s m ih sh ah n
transmit	t r ae n z m ih t
transparent	t r ae n s p eh r ah n t
transpire	t r ae n s p ay er
transpired	t r ae n s p ay er d
transpiring	t r ae n s p ay er ih ng
transportation	t r ae n s p er t ey sh ah n
transported	t r ae n s p ao r t ah d
transports	t r ae n s p ao r t s
trap	t r ae p
trapped	t r ae p t
trappings	t r ae p ih ng z
travel	t r ae v ah l
traveling	t r ae v ah l ih ng
travelled	t r ae v ah l d
travelling	t r ae v ah l ih ng
traverse	t r ae v er s
traversed	t r ae v er s t
travesty	t r ae v ah s t iy
tread	t r eh d
treason	t r iy z ah n
treat	t r iy t
treated	t r iy t ah d
treatment	t r iy t m ah n t
tree	t r iy
trees	t r iy z
trembled	t r eh m b ah l d
trembling	t r eh m b ah l ih ng
tremendous	t r ah m eh n d ah s
tremor	t r eh m er
trial	t r ay ah l
triangular	t r ay ae ng g y ah l er
tribe	t r ay b
tribes	t r ay b z
tribesmen	t r ay b z m ih n
tribunal	t r ah b y uw n ah l
tribute	t r ih b y uw t
trick	t r ih k
tricked	t r ih k t
tried	t r ay d
trifle	t r ay f ah l
trifling	t r ay f l ih ng
trigger	t r ih g er
trimming	t r ih m ih ng
trio	t r iy ow
trip	t r ih p
trips	t r ih p s
triumph	t r ay ah m f
triumphal	t r ay ah m f ah l
triumphant	t r ay ah m f ah n t
troops	t r uw p s
trouble	t r ah b ah l
troubled	t r ah b ah l d
troubles	t r ah b ah l z
truce	t r uw s
true	t r uw
truly	t r uw l iy
truncated	t r ah ng k ey t ih d
trunk	t r ah ng k
trust	t r ah s t
trusted	t r ah s t ih d
trusting	t r ah s t ih ng
truth	t r uw th
try	t r ay
trying	t r ay ih ng
tube	t uw b
tug	t ah g
tumbled	t ah m b ah l d
tumult	t uw m ah l t
tunnel	t ah n ah l
tunnels	t ah n ah l z
turf	t er f
turmoil	t er m oy l
turn	t er n
turned	t er n d
turning	t er n ih ng
turns	t er n z
turquoise	t er k w oy z
tusks	t ah s k s
twelve	t w eh l v
twenty	t w eh n t iy
twice	t w ay s
twig	t w ih g
twigs	t w ih g z
twilight	t w ay l ay t
twin	t w ih n
twisting	t w ih s t ih ng
twitched	t w ih ch t
two	t uw
twos	t uw z
type	t ay p
types	t ay p s
typical	t ih p ah k ah l
tyrant	t ay r ah n t
ugly	ah g l iy
ultimate	ah l t ah m ah t
umbrella	ah m b r eh l ah
un	ah n
unable	ah n ey b ah l
unaccountable	ah n ah k aw n t ah b ah l
unaccustomed	ah n ah k ah s t ah m d
unadorned	ah n ah d ao r n d
unafraid	ah n ah f r ey d
unalterable	ah n ao l t er ah b ah l
unanimity	y uw n ah n ih m ah t iy
unanswered	ah n ae n s er d
unarmed	ah n aa r m d
unbelievable	ah n b ah l iy v ah b ah l
unbelieving	ah n b ah l iy v ih ng
unbend	ah n b eh n d
unborn	ah n b ao r n
unbroken	ah n b r ow k ah n
uncanny	ah n k ae n iy
uncertain	ah n s er t ah n
uncertainty	ah n s er t ah n t iy
uncle	ah ng k ah l
uncomfortable	ah n k ah m f er t ah b ah l
uncompromising	ah n k aa m p r ah m ay z ih ng
unconscious	ah n k aa n sh ah s
unconsciousness	ah n k aa n sh ah s n ih s
uncontrollable	ah n k ah n t r ow l ah b ah l
uncovered	ah n k ah v er d
undaunted	ah n d ao n t ih d
under	ah n d er
underfoot	ah n d er f uh t
undergoing	ah n d er g ow ih ng
underground	ah n d er g r aw n d
underneath	ah n d er n iy th
understand	ah n d er s t ae n d
understanding	ah n d er s t ae n d ih ng
understood	ah n d er s t uh d
undervalue	ah n d er v ae l y uw
underwent	ah n d er w eh n t
underworld	ah n d er w er l d
undetected	ah n d ih t eh k t ih d
unearthly	ah n er th l iy
unequal	ah n iy k w ah l
uneventful	ah n iy v eh n t f ah l
unexpected	ah n ih k s p eh k t ih d
unfamiliar	ah n f ah m ih l y er
unfold	ah n f ow l d
unfolded	ah n f ow l d ah d
unfortunately	ah n f ao r ch ah n ah t l iy
unfortunates	ah n f ao r ch ah n ah t s
unfriendly	ah n f r eh n d l iy
ungainly	ah n g ey n l iy
unguarded	ah n g aa r d ih d
unhappy	ah n hh ae p iy
unharmed	ah n hh aa r m d
unheard	ah n hh er d
uniform	y uw n ah f ao r m
uniformly	y uw n ah f ao r m l iy
uninterrupted	ah n ih n t er ah p t ih d
universe	y uw n ah v er s
unjust	ah n jh ah s t
unknown	ah n n ow n
unless	ah n l eh s
unlike	ah n l ay k
unlock	ah n l aa k
unlocking	ah n l aa k ih ng
unmarked	ah n m aa r k t
unoccupied	ah n aa k y ah p ay d
unopened	ah n ow p ah n d
unprotected	ah n p r ah t eh k t ih d
unquestionably	ah n k w eh s ch ah n ah b l iy
unreasoning	ah n r iy z n ih ng
unscathed	ah n s k ey dh d
unseen	ah n s iy n
unspeakable	ah n s p iy k ah b ah l
unspoken	ah n s p ow k ah n
untainted	ah n t ey n t ih d
unthinkable	ah n th ih ng k ah b ah l
until	ah n t ih l
unto	ah n t uw
unyielding	ah n y iy l d ih ng
up	ah p
upon	ah p aa n
upper	ah p er
uprooting	ah p r uw t ih ng
upward	ah p w er d
urged	er jh d
urging	er jh ih ng
us	ah s
use	y uw s
used	y uw z d
useless	y uw s l ah s
uses	y uw s ah z
ushered	ah sh er d
usually	y uw zh ah w ah l iy
utilized	y uw t ah l ay z d
utmost	ah t m ow s t
utter	ah t er
utterly	ah t er l iy
v	v iy
vacant	v ey k ah n t
vagrant	v ey g r ah n t
vague	v ey g
vain	v ey n
valley	v ae l iy
valuable	v ae l y ah b ah l
value	v ae l y uw
values	v ae l y uw z
vandal	v ae n d ah l
vanished	v ae n ih sh t
varied	v eh r iy d
variegated	v eh r ih g ey t ah d
various	v eh r iy ah s
vary	v eh r iy
varying	v eh r iy ih ng
vassals	v ae s ah l z
vast	v ae s t
vastly	v ae s t l iy
vault	v ao l t
vaulted	v ao l t ih d
vaulting	v ao l t ih ng
veered	v ih r d
vegetation	v eh jh ah t ey sh ah n
veiled	v ey l d
veins	v ey n z
velocity	v ah l aa s ah t iy
vengeance	v eh n jh ah n s
vengeful	v eh n jh f ah l
venture	v eh n ch er
veracity	v er ae s ih t iy
verdict	v er d ih k t
verge	v er jh
verifying	v eh r ah f ay ih ng
veritable	v eh r ih t ah b ah l
vertebral	v er t ah b r ah l
very	v eh r iy
vessel	v eh s ah l
vessels	v eh s ah l z
vestige	v eh s t ih jh
veteran	v eh t er ah n
vi	v ay
vibrate	v ay b r ey t
vicinity	v ah s ih n ah t iy
vicious	v ih sh ah s
viciously	v ih sh ah s l iy
victim	v ih k t ih m
victims	v ih k t ih m z
victorious	v ih k t ao r iy ah s
victors	v ih k t er z
victory	v ih k t ah r iy
view	v y uw
viewed	v y uw d
vile	v ay l
village	v ih l ah jh
villages	v ih l ah jh ih z
villain	v ih l ah n
vindictive	v ih n d ih k t ih v
violation	v ay ah l ey sh ah n
virginia	v er jh ih n y ah
virginian	v er jh ih n y ah n
virtue	v er ch uw
virtues	v er ch uw z
visible	v ih z ah b ah l
vision	v ih zh ah n
visit	v ih z ih t
visited	v ih z ih t ih d
visiting	v ih z ih t ih ng
vitality	v ay t ae l ah t iy
vivacious	v ah v ey sh ah s
vivid	v ih v ah d
vividly	v ih v ah d l iy
vocation	v ow k ey sh ah n
voice	v oy s
voiced	v oy s t
voiceless	v oy s l ah s
voices	v oy s ah z
void	v oy d
volition	v ow l ih sh ah n
volley	v aa l iy
volume	v aa l y uw m
voluntarily	v aa l ah n t eh r ah l iy
voluntary	v aa l ah n t eh r iy
volunteered	v aa l ah n t ih r d
vortex	v ao r t eh k s
vow	v aw
voyagers	v oy ih jh er z
vulgar	v ah l g er
waging	w ey jh ih ng
wail	w ey l
waist	w ey s t
wait	w ey t
waited	w ey t ih d
waiting	w ey t ih ng
wake	w ey k
walk	w ao k
walked	w ao k t
walking	w ao k ih ng
walks	w ao k s
wall	w ao l
walled	w ao l d
walls	w ao l z
wander	w aa n d er
wandered	w aa n d er d
wanderer	w aa n d er er
wanderers	w aa n d er er z
wandering	w aa n d er ih ng
wanderings	w aa n d er ih ng z
waning	w ey n ih ng
want	w aa n t
wanted	w ao n t ih d
war	w ao r
warfare	w ao r f eh r
warily	w eh r ah l iy
wariness	w eh r iy n ih s
warlike	w ao r l ay k
warm	w ao r m
warmth	w ao r m th
warned	w ao r n d
warning	w ao r n ih ng
warrant	w ao r ah n t
warring	w ao r ih ng
warrior	w ao r iy er
warriors	w ao r iy er z
was	w aa z
wash	w aa sh
waste	w ey s t
wasted	w ey s t ah d
wasting	w ey s t ih ng
watch	w aa ch
watched	w aa ch t
watchers	w aa ch er z
watching	w aa ch ih ng
water	w ao t er
waters	w ao t er z
waterway	w ao t er w ey
waterways	w ao t er w ey z
watery	w ao t er iy
wave	w ey v
waved	w ey v d
wavering	w ey v er ih ng
waving	w ey v ih ng
way	w ey
ways	w ey z
we	w iy
weak	w iy k
weakening	w iy k ah n ih ng
weaker	w iy k er
weakling	w iy k l ih ng
weakly	w iy k l iy
wealth	w eh l th
weapon	w eh p ah n
weapons	w eh p ah n z
wear	w eh r
wearer	w eh r er
wearing	w eh r ih ng
wedded	w eh d ah d
wedding	w eh d ih ng
wedge	w eh jh
wedged	w eh jh d
weeks	w iy k s
weigh	w ey
weighed	w ey d
weight	w ey t
weird	w ih r d
welcome	w eh l k ah m
welcomed	w eh l k ah m d
well	w eh l
went	w eh n t
wept	w eh p t
were	w er
west	w eh s t
western	w eh s t er n
whack	w ae k
whacked	w ae k t
wharf	w ao r f
what	w ah t
whatever	w ah t eh v er
whatsoever	w ah t s ow eh v er
wheel	w iy l
wheeled	w iy l d
when	w eh n
whence	w eh n s
whenever	w eh n eh v er
where	w eh r
whereabouts	w eh r ah b aw t s
whereby	w eh r b ay
wherein	w eh r ih n
wherever	w eh r eh v er
whether	w eh dh er
which	w ih ch
while	w ay l
whim	w ih m
whipped	w ih p t
whipping	w ih p ih ng
whirring	w er ih ng
whisper	w ih s p er
whispered	w ih s p er d
whispering	w ih s p er ih ng
whistle	w ih s ah l
whistling	w ih s l ih ng
white	w ay t
whiteness	w ay t n ah s
whites	w ay t s
whither	w ih dh er
whizzed	w ih z d
who	hh uw
whoever	hh uw eh v er
whole	hh ow l
whom	hh uw m
whose	hh uw z
whosoever	hh uw s ow eh v er
why	w ay
wicked	w ih k ah d
wide	w ay d
widely	w ay d l iy
widened	w ay d ah n d
widening	w ay d ah n ih ng
wider	w ay d er
widespread	w ay d s p r eh d
width	w ih d th
wield	w iy l d
wielding	w iy l d ih ng
wife	w ay f
wig	w ih g
wild	w ay l d
wilderness	w ih l d er n ah s
wildly	w ay l d l iy
wilds	w ay l d z
will	w ih l
willing	w ih l ih ng
wilt	w ih l t
win	w ih n
wind	w ay n d
winding	w ay n d ih ng
window	w ih n d ow
windows	w ih n d ow z
winds	w ih n d z
winged	w ih ng d
winging	w ih ng ih ng
winning	w ih n ih ng
wipe	w ay p
wire	w ay er
wireless	w ay r l ih s
wisdom	w ih z d ah m
wise	w ay z
wiser	w ay z er
wish	w ih sh
wished	w ih sh t
wistful	w ih s t f ah l
wit	w ih t
with	w ih dh
withdraw	w ih dh d r ao
withdrew	w ih th d r uw
within	w ih dh ih n
without	w ih th aw t
withstand	w ih th s t ae n d
withstood	w ih th s t uh d
witness	w ih t n ah s
witnessed	w ih t n ah s t
witnessing	w ih t n ah s ih ng
wits	w ih t s
wives	w ay v z
woman	w uh m ah n
women	w ih m ah n
won	w ah n
wonder	w ah n d er
wondered	w ah n d er d
wonderful	w ah n d er f ah l
wondering	w ah n d er ih ng
wonderment	w ah n d er m ah n t
wondrous	w ah n d r ah s
wont	w ow n t
wood	w uh d
wooden	w uh d ah n
word	w er d
words	w er d z
wore	w ao r
work	w er k
worked	w er k t
working	w er k ih ng
works	w er k s
world	w er l d
worlds	w er l d z
worm	w er m
worn	w ao r n
worry	w er iy
worse	w er s
worship	w er sh ah p
worshipped	w er sh ah p t
worst	w er s t
worth	w er th
would	w uh d
wound	w aw n d
wounded	w uw n d ih d
wounding	w uw n d ih ng
wounds	w uw n d z
wove	w ow v
wrapped	r ae p t
wrath	r ae th
wreak	r iy k
wreaked	r iy k t
wrecking	r eh k ih ng
wrench	r eh n ch
wrenched	r eh n ch t
wrest	r eh s t
wrested	r eh s t ih d
wriggle	r ih g ah l
wrinkled	r ih ng k ah l d
wrist	r ih s t
wrists	r ih s t s
writ	r ih t
write	r ay t
writhe	r ih th
writhing	r ay dh ih ng
writing	r ay t ih ng
written	r ih t ah n
wrong	r ao ng
wrongs	r ao ng z
wrote	r ow t
wrought	r ao t
wrung	r ah ng
wry	r ay
yard	y aa r d
yards	y aa r d z
yawned	y ao n d
yawning	y ao n ih ng
year	y ih r
yearning	y er n ih ng
yearns	y er n z
years	y ih r z
yelled	y eh l d
yelling	y eh l ih ng
yellow	y eh l ow
yellows	y eh l ow z
yes	y eh s
yesterday	y eh s t er d ey
yet	y eh t
yield	y iy l d
yielded	y iy l d ah d
yields	y iy l d z
yonder	y aa n d er
you	y uw
young	y ah ng
your	y ao r
yours	y uh r z
yourself	y er s eh l f
youth	y uw th
youthful	y uw th f ah l
zenith	z iy n ih th